30 100
GATCTCGTTTGACTGGCTTTCCAGCGAACA|TGTGGGCTCATTAATCTGGCAAGCGTATCA
CCAGCGAACAGGCAAAATTCACTAACCGTG|AAGCGTATCAGTTCCCCTTTAAACCAAGCG
GACACCCGTGTCGCTATCACATACATGTCC|GCGGCGATAGGTATGACCGTGTCGCTATCA
ACTAGCCACCGCTGTCGCCGGCGAAATTTA|ACAGTTATTTACCGTGTCGCTATCACATAC
CAGAGGGACTAGCCACCGCTGTCGCCGGCG|CGACGGGACAGTTATTTACCGTGTCGCTAT
CCGTGTCGCTATCACATACATGTCCTGGTT|GATAGGTATGACCGTGTCGCTATCACATAC
CATACATGTCCTGGTTATACATGTCCTGGT|TGCACGGAAATACCGATCAGCGGCAAAGCA
CGGTATGACACCCGTGTCGCTATCACATAC|AGTGTGGCGGCGATAGGTATGACCGTGTCG
AACCTGAAATAATGTACGCTCTTCGGGGTA|GTGTCGCTATCACATACATGTCCTGGTTCA
TGTCCTGGTTGAGTCGCCCACCTGATCTCG|GCAAAAACCTACTTCCTTAACCGTGTGGGC
CGCTATCACATACATGTCCTGGTTCAACGC|ACGCCCTGGCAATAACCCAAGATATTCTGG
TGGTTCAACGCCTAGATCACATCTCTTTTA|AGATATTCTGGGAAGAAGAAGGTAAGGAGT
CACCGTGTCGCTATCACATACATGTCCTGG|TGGATATCCATCTTGCGAGTGCACTGTGGA
GTTCCCCTTTAAACCAAGCGGACGCCCTGG|TGGCACTTTGCTCCATCGCGCCCCGGGACA
AGATACAGATGCCCAACAATAATTCCGCAA|TTAGTCCCGCAAATATAGGCCCAGGCCCAG
TACATGTCCTGGTTACAGGGTGTGATCTTG|GGTTTCCGACATAAGGGTAAGGACGGTCGA
CATCCGTGTCGCTATCACATACATGTCCTG|GCTATCACATACATGTCCTGGTTATACATG
TGTCGCTATCACATACATGTCCTGGTTTCC|AACCTGAAATAATGTACGCTCTTCGGGGTA
GTGGGCTCATTAATCTGGCAAGCGTATCAG|CGCTATCACATACATGTCCTGGTTTACCCT
TCCACTCTTGCGTAAACAAGTTGATCGTTT|CCCGTGTCGCTATCACATACATGTCCTGGT
ACATACATGTCCTGGTTATACATGTCCTGG|CTGCACGGAAATACCGATCAGCGGCAAAGC
AAGCATGAAGTTAGTGTGGCGGCGATAGGT|GTGTATCCACTCTTGCGTAAACAAGTTGAT
ATACATGTCCTGGTTCAACGCCTAGATCAC|CAATAACCCAAGATATTCTGGGAAGAAGAA
TCACATCTCTTTTAGCTCGAAGCAAAAACC|AGAAGGTAAGGAGTCGCGCTGGATTAGAGC
AGTGTGGCGGCGATAGGTATGACCGTGTCG|TTGCGTAAACAAGTTGATCGTTTTCCTAGG
CGCTGGATTAGAGCTCCGGACATCCGTGTC|GTGTCGCTATCACCCGTGTCGCTATCACAT
TTGATCGTTTTCCTAGGTCCACAGCAAGGA|ATGTCCTGGTTCAACTCGTTCAAGCACTCC
GCACTGTGGACAGAGATACAGATGCCCAAC|GAGACATTAGGGCTTAGTCCCGCAAATATA
TGTCGCTATCACCCGTGTCGCTATCACATA|ACATACATGTCCTGGTTTAGCGAACCTGCA
ACCCTGGCACTTTGCTCCATCGCGCCCCGG|GGTTAAGATCCGGTATGACACCCGTGTCGC
ATGTCCTGGTTTTTTAAAATAACACCGTGT|CTATCACATACATGTCCTGGTTTGGATATC
TATCACATACATGTCCTGGTTTACCCTGGC|ATGTCCTGGTTATACATGTCCTGGTTAAGA
TCGCCGGCGAAATTTACGTCGAGCTCTGCG|TGTCGCTATCACATACATGTCCTGGTTATA
CACCCGTGTCGCTATCACATACATGTCCTG|TCCTGGTTTAGCGAACCTGCACGGAAATAC
GAAATAATGTACGCTCTTCGGGGTAAACAC|GCTATCACATACATGTCCTGGTTCAACGCC
ACAGGCAAAATTCACTAACCGTGTCGCTAT|TCAGTTCCCCTTTAAACCAAGCGGACGCCC
CTTCCGTGAACCTGAAATAATGTACGCTCT|CACTAACCGTGTCGCTATCACATACATGTC
CGGCAAAGCATGAAGTTAGTGTGGCGGCGA|AATACGTGTATCCACTCTTGCGTAAACAAG
GTTAAGATCCGGTATGACACCCGTGTCGCT|CATGAAGTTAGTGTGGCGGCGATAGGTATG
GGTTACAGGGTGTGATCTTGATTATGCAGA|ATAAGGGTAAGGACGGTCGAGCTTAGCGAC
TGTGGGCTCATTAATCTGGCAAGCGTATCA|TCGCTATCACATACATGTCCTGGTTTACCC
CGGGACAAACCGGCTAAATAGGTCACGTGC|CGCTATCACATACATGTCCTGGTTTTTTAA
TACATGTCCTGGTTTTTTAAAATAACACCG|TCGCTATCACATACATGTCCTGGTTTGGAT
TACATGTCCTGGTTTCCGACATAAGGGTAA|GTACGCTCTTCGGGGTAAACACTACGTCCG
GCTATCACATACATGTCCTGGTTTGGATAT|GTCCACAGCAAGGATAAGGTTGCGGACCTC
CTGGCTTTCCAGCGAACAGGCAAAATTCAC|AATCTGGCAAGCGTATCAGTTCCCCTTTAA
CCGGTATGACACCCGTGTCGCTATCACATA|TAGTGTGGCGGCGATAGGTATGACCGTGTC
CACCTGATCTCGTTTGACTGGCTTTCCAGC|AACCGTGTGGGCTCATTAATCTGGCAAGCG
ACATACATGTCCTGGTTGAATTAGAGAAGA|CTGGTTGTGAGTTAACTATCAAGCCGTTCT
TTATGCAGAGGGACTAGCCACCGCTGTCGC|CTTAGCGACGGGACAGTTATTTACCGTGTC
TGTCGCTATCACATACATGTCCTGGTTGAA|CATACATGTCCTGGTTGTGAGTTAACTATC
TCTTCGGGGTAAACACTACGTCCGTGTCGC|GTCCTGGTTCAACGCCTAGATCACATCTCT
GATATTCTGGGAAGAAGAAGGTAAGGAGTC|TAGGTCACGTGCGTGCATGCCGTAACAGTC
GACAGTTATTTACCGTGTCGCTATCACATA|TGGTTGAGTCGCCCACCTGATCTCGTTTGA
ATGTCCTGGTTTACCCTGGCACTTTGCTCC|TATACATGTCCTGGTTAAGATCCGGTATGA
AGCGGACGCCCTGGCAATAACCCAAGATAT|CGCGCCCCGGGACAAACCGGCTAAATAGGT
GTCGCTATCACCCGTGTCGCTATCACATAC|CATACATGTCCTGGTTTAGCGAACCTGCAC
ACAGATGCCCAACAATAATTCCGCAATACG|TCCCGCAAATATAGGCCCAGGCCCAGGCGT
GCTATCACATACATGTCCTGGTTATATCCC|ATCTCGTTTGACTGGCTTTCCAGCGAACAG
GGACCTCTGATCCCGCAGCCGAGACATTAG|TTACACCGTGTCGCTATCACATACATGTCC
CGGCTAAATAGGTCACGTGCGTGCATGCCG|TACATGTCCTGGTTTTTTAAAATAACACCG
CCTGGTTGAGTCGCCCACCTGATCTCGTTT|AAAACCTACTTCCTTAACCGTGTGGGCTCA
CTAAATAGGTCACGTGCGTGCATGCCGTAA|ATGTCCTGGTTTTTTAAAATAACACCGTGT
CATGAAGTTAGTGTGGCGGCGATAGGTATG|TATCCACTCTTGCGTAAACAAGTTGATCGT
TAACCCAAGATATTCTGGGAAGAAGAAGGT|CGGCTAAATAGGTCACGTGCGTGCATGCCG
TGTATCCACTCTTGCGTAAACAAGTTGATC|TGCCCCCGTGTCGCTATCACATACATGTCC
AATCTGGCAAGCGTATCAGTTCCCCTTTAA|ACATGTCCTGGTTTACCCTGGCACTTTGCT
TGCATTTCATCCGGTATTGCAGGCAGTATC|AAATTTACGTCGAGCTCTGCGGTAGGATCC
TCGTTCAAGCACTCCAGTACTAGTTTACAC|CATGTCCTGGTTGAAGTACCGTGTCGCTAT
GTGTCGCTATCACATACATGTCCTGGTTTG|CCTAGGTCCACAGCAAGGATAAGGTTGCGG
CGGTATTGCAGGCAGTATCACGTGTCGGCT|GAGCTCTGCGGTAGGATCCATGCTTGTCCG
TATGACCGTGTCGCTATCACATACATGTCC|TCGTTTTCCTAGGTCCACAGCAAGGATAAG
ATAACCCAAGATATTCTGGGAAGAAGAAGG|CCGGCTAAATAGGTCACGTGCGTGCATGCC
TTTTTAAAATAACACCGTGTCGCTATCACA|CATGTCCTGGTTTGGATATCCATCTTGCGA
CAAGGATAAGGTTGCGGACCTCTGATCCCG|CACTCCAGTACTAGTTTACACCGTGTCGCT
GTCGCTATCACATACATGTCCTGGTTGAAT|ATACATGTCCTGGTTGTGAGTTAACTATCA
TATCACCCGTGTCGCTATCACATACATGTC|ATGTCCTGGTTTAGCGAACCTGCACGGAAA
CTGAAATAATGTACGCTCTTCGGGGTAAAC|TCGCTATCACATACATGTCCTGGTTCAACG
TGGTTACAGGGTGTGATCTTGATTATGCAG|CATAAGGGTAAGGACGGTCGAGCTTAGCGA
CTTTAAACCAAGCGGACGCCCTGGCAATAA|TTTGCTCCATCGCGCCCCGGGACAAACCGG
GAAGCAAAAACCTACTTCCTTAACCGTGTG|CTGGATTAGAGCTCCGGACATCCGTGTCGC
AGCAAGGATAAGGTTGCGGACCTCTGATCC|AGCACTCCAGTACTAGTTTACACCGTGTCG
TAAACAAGTTGATCGTTTTCCTAGGTCCAC|TCACATACATGTCCTGGTTCAACTCGTTCA
GAGTCGCCCACCTGATCTCGTTTGACTGGC|ACTTCCTTAACCGTGTGGGCTCATTAATCT
AGGTAAGGAGTCGCGCTGGATTAGAGCTCC|GCCGTAACAGTCCGTGTCGCTATCACCCGT
CATGTCCTGGTTCAACTCGTTCAAGCACTC|GTGTCGCTATCACATACATGTCCTGGTTGA
CAGTTATTTACCGTGTCGCTATCACATACA|GTTGAGTCGCCCACCTGATCTCGTTTGACT
TTAGTGTGGCGGCGATAGGTATGACCGTGT|TCTTGCGTAAACAAGTTGATCGTTTTCCTA
TTCTTACTTCCGTGAACCTGAAATAATGTA|AAAATTCACTAACCGTGTCGCTATCACATA
GAAATTTACGTCGAGCTCTGCGGTAGGATC|TCACATACATGTCCTGGTTATATCCCAATT
GTGTCGCTATCACATACATGTCCTGGTTTA|TATCCATCTTGCGAGTGCACTGTGGACAGA
GACAGAGATACAGATGCCCAACAATAATTC|AGGGCTTAGTCCCGCAAATATAGGCCCAGG
CTTACTTCCGTGAACCTGAAATAATGTACG|AATTCACTAACCGTGTCGCTATCACATACA
TAGCGAACCTGCACGGAAATACCGATCAGC|GAGATACAGATGCCCAACAATAATTCCGCA
TGCGAGTGCACTGTGGACAGAGATACAGAT|CGCAGCCGAGACATTAGGGCTTAGTCCCGC
CCGCAGCCGAGACATTAGGGCTTAGTCCCG|GCTATCACATACATGTCCTGGTTGAATTAG
CACCGCTGTCGCCGGCGAAATTTACGTCGA|ATTTACCGTGTCGCTATCACATACATGTCC
AGCCGAGACATTAGGGCTTAGTCCCGCAAA|TCACATACATGTCCTGGTTGAATTAGAGAA
ACATGTCCTGGTTATACATGTCCTGGTTAA|ACGGAAATACCGATCAGCGGCAAAGCATGA
TAACCGTGTGGGCTCATTAATCTGGCAAGC|TCCGTGTCGCTATCACATACATGTCCTGGT
GTTGCGGACCTCTGATCCCGCAGCCGAGAC|CTAGTTTACACCGTGTCGCTATCACATACA
TCCAGTACTAGTTTACACCGTGTCGCTATC|GAAGTACCGTGTCGCTATCACATACATGTC
CCGTGTCGCTATCACATACATGTCCTGGTT|CACATCTCTTTTAGCTCGAAGCAAAAACCT
GTGTCGCTATCACATACATGTCCTGGTTGA|CATCTCTTTTAGCTCGAAGCAAAAACCTAC
TAGGGCTTAGTCCCGCAAATATAGGCCCAG|TCCTGGTTGAATTAGAGAAGAATATTGTTC
TTTAGCGAACCTGCACGGAAATACCGATCA|CAGAGATACAGATGCCCAACAATAATTCCG
CGATAGGTATGACCGTGTCGCTATCACATA|AAGTTGATCGTTTTCCTAGGTCCACAGCAA
CGCTATCACATACATGTCCTGGTTATATCC|GATCTCGTTTGACTGGCTTTCCAGCGAACA
TAGTTGCATTTCATCCGGTATTGCAGGCAG|GGCGAAATTTACGTCGAGCTCTGCGGTAGG
AAAGCATGAAGTTAGTGTGGCGGCGATAGG|CGTGTATCCACTCTTGCGTAAACAAGTTGA
TACAGGGTGTGATCTTGATTATGCAGAGGG|AGGGTAAGGACGGTCGAGCTTAGCGACGGG
ATTTACGTCGAGCTCTGCGGTAGGATCCAT|CATACATGTCCTGGTTATATCCCAATTCTT
TTATATCCCAATTCTTACTTCCGTGAACCT|AGCGAACAGGCAAAATTCACTAACCGTGTC
TCATCCGGTATTGCAGGCAGTATCACGTGT|ACGTCGAGCTCTGCGGTAGGATCCATGCTT
TATGACACCCGTGTCGCTATCACATACATG|GTGGCGGCGATAGGTATGACCGTGTCGCTA
ATCCGTGTCGCTATCACATACATGTCCTGG|CTATCACATACATGTCCTGGTTATACATGT
GCTATCACATACATGTCCTGGTTCAACGCC|CGCCCTGGCAATAACCCAAGATATTCTGGG
CAGTTCCCCTTTAAACCAAGCGGACGCCCT|CCTGGCACTTTGCTCCATCGCGCCCCGGGA
CGGAAATACCGATCAGCGGCAAAGCATGAA|CCAACAATAATTCCGCAATACGTGTATCCA
TCCTGGTTCAACTCGTTCAAGCACTCCAGT|CGCTATCACATACATGTCCTGGTTGAAGTA
CGTTCAAGCACTCCAGTACTAGTTTACACC|ATGTCCTGGTTGAAGTACCGTGTCGCTATC
ACTACGTCCGTGTCGCTATCACATACATGT|CCTAGATCACATCTCTTTTAGCTCGAAGCA
TCGCGCCCCGGGACAAACCGGCTAAATAGG|ACCCGTGTCGCTATCACATACATGTCCTGG
GCAAAGCATGAAGTTAGTGTGGCGGCGATA|TACGTGTATCCACTCTTGCGTAAACAAGTT
GGTAAGGACGGTCGAGCTTAGCGACGGGAC|GTCCGTGTCGCTATCACATACATGTCCTGG
GAGTCGCGCTGGATTAGAGCTCCGGACATC|CAGTCCGTGTCGCTATCACCCGTGTCGCTA
TATATCCCAATTCTTACTTCCGTGAACCTG|GCGAACAGGCAAAATTCACTAACCGTGTCG
TGGTTGAATTAGAGAAGAATATTGTTCTTA|TAACTATCAAGCCGTTCTACCGCGCCCTAA
CGTGTCGGCTACTTACGCCGTGTCGCTATC|TGCTTGTCCGTGTCGCTATCACATACATGT
AGGACGGTCGAGCTTAGCGACGGGACAGTT|GTGTCGCTATCACATACATGTCCTGGTTGA
TTAAGATCCGGTATGACACCCGTGTCGCTA|ATGAAGTTAGTGTGGCGGCGATAGGTATGA
GATTAGAGCTCCGGACATCCGTGTCGCTAT|GCTATCACCCGTGTCGCTATCACATACATG
CTATCACATACATGTCCTGGTTTTTTAAAA|TGACCGTGTCGCTATCACATACATGTCCTG
TTGCAGGCAGTATCACGTGTCGGCTACTTA|CTGCGGTAGGATCCATGCTTGTCCGTGTCG
CCCGTGTCGCTATCACATACATGTCCTGGT|CTGGTTTAGCGAACCTGCACGGAAATACCG
TGCAGAGGGACTAGCCACCGCTGTCGCCGG|AGCGACGGGACAGTTATTTACCGTGTCGCT
GGTATGACCGTGTCGCTATCACATACATGT|GATCGTTTTCCTAGGTCCACAGCAAGGATA
TGGTTTGGATATCCATCTTGCGAGTGCACT|GTTGCGGACCTCTGATCCCGCAGCCGAGAC
TAAACCAAGCGGACGCCCTGGCAATAACCC|GCTCCATCGCGCCCCGGGACAAACCGGCTA
GAAGTTAGTGTGGCGGCGATAGGTATGACC|CCACTCTTGCGTAAACAAGTTGATCGTTTT
GTCGCTATCACATACATGTCCTGGTTTGGA|TAGGTCCACAGCAAGGATAAGGTTGCGGAC
CCTTAACCGTGTGGGCTCATTAATCTGGCA|ACATCCGTGTCGCTATCACATACATGTCCT
GTGTGATCTTGATTATGCAGAGGGACTAGC|AGGACGGTCGAGCTTAGCGACGGGACAGTT
CACATACATGTCCTGGTTTAGCGAACCTGC|GCGAGTGCACTGTGGACAGAGATACAGATG
ACATGTCCTGGTTTTTTAAAATAACACCGT|CGCTATCACATACATGTCCTGGTTTGGATA
GGACGGTCGAGCTTAGCGACGGGACAGTTA|TGTCGCTATCACATACATGTCCTGGTTGAG
GCCCAGGCCCAGGCGTTGCCCCCGTGTCGC|TTGTTCTTACAGTGCGGCGAGCCGACGTCG
TAAGGGTAAGGACGGTCGAGCTTAGCGACG|CTACGTCCGTGTCGCTATCACATACATGTC
AGGGTAAGGACGGTCGAGCTTAGCGACGGG|ACGTCCGTGTCGCTATCACATACATGTCCT
TGTCGCTATCACATACATGTCCTGGTTTAC|ACATACATGTCCTGGTTATACATGTCCTGG
GTACTAGTTTACACCGTGTCGCTATCACAT|TACCGTGTCGCTATCACATACATGTCCTGG
GGACAGAGATACAGATGCCCAACAATAATT|TAGGGCTTAGTCCCGCAAATATAGGCCCAG
CTGGTTGAATTAGAGAAGAATATTGTTCTT|TTAACTATCAAGCCGTTCTACCGCGCCCTA
CTGGTTGAGTCGCCCACCTGATCTCGTTTG|AAACCTACTTCCTTAACCGTGTGGGCTCAT
GACGGGACAGTTATTTACCGTGTCGCTATC|TGTCCTGGTTGAGTCGCCCACCTGATCTCG
TGAAGTTAGTGTGGCGGCGATAGGTATGAC|TCCACTCTTGCGTAAACAAGTTGATCGTTT
CTATCACATACATGTCCTGGTTATATCCCA|TCTCGTTTGACTGGCTTTCCAGCGAACAGG
CTGTGGACAGAGATACAGATGCCCAACAAT|ACATTAGGGCTTAGTCCCGCAAATATAGGC
GAGACATTAGGGCTTAGTCCCGCAAATATA|ATACATGTCCTGGTTGAATTAGAGAAGAAT
TCTTGCGTAAACAAGTTGATCGTTTTCCTA|GTCGCTATCACATACATGTCCTGGTTCAAC
CGCTATCACATACATGTCCTGGTTTGGATA|GGTCCACAGCAAGGATAAGGTTGCGGACCT
TTTTTTAAAATAACACCGTGTCGCTATCAC|ACATGTCCTGGTTTGGATATCCATCTTGCG
CTATCACATACATGTCCTGGTTTACCCTGG|CATGTCCTGGTTATACATGTCCTGGTTAAG
CGGCGATAGGTATGACCGTGTCGCTATCAC|AACAAGTTGATCGTTTTCCTAGGTCCACAG
CCTGATCTCGTTTGACTGGCTTTCCAGCGA|CCGTGTGGGCTCATTAATCTGGCAAGCGTA
CAGCAAGGATAAGGTTGCGGACCTCTGATC|AAGCACTCCAGTACTAGTTTACACCGTGTC
ACGTGTCGGCTACTTACGCCGTGTCGCTAT|ATGCTTGTCCGTGTCGCTATCACATACATG
AGCCACCGCTGTCGCCGGCGAAATTTACGT|GTTATTTACCGTGTCGCTATCACATACATG
ACATACATGTCCTGGTTGAGTCGCCCACCT|GCTCGAAGCAAAAACCTACTTCCTTAACCG
TGCTTGTCCGTGTCGCTATCACATACATGT|TACTTCCGTGAACCTGAAATAATGTACGCT
AAGCACTCCAGTACTAGTTTACACCGTGTC|CTGGTTGAAGTACCGTGTCGCTATCACATA
GAAGGTAAGGAGTCGCGCTGGATTAGAGCT|ATGCCGTAACAGTCCGTGTCGCTATCACCC
GCAAAATTCACTAACCGTGTCGCTATCACA|TTCCCCTTTAAACCAAGCGGACGCCCTGGC
GCGTAAACAAGTTGATCGTTTTCCTAGGTC|CTATCACATACATGTCCTGGTTCAACTCGT
AGCGACGGGACAGTTATTTACCGTGTCGCT|ACATGTCCTGGTTGAGTCGCCCACCTGATC
ATCCATCTTGCGAGTGCACTGTGGACAGAG|TCTGATCCCGCAGCCGAGACATTAGGGCTT
TCACTAACCGTGTCGCTATCACATACATGT|TTAAACCAAGCGGACGCCCTGGCAATAACC
TATCACATACATGTCCTGGTTTGGATATCC|CCACAGCAAGGATAAGGTTGCGGACCTCTG
TGCGTGCATGCCGTAACAGTCCGTGTCGCT|TAAAATAACACCGTGTCGCTATCACATACA
TTAGGGCTTAGTCCCGCAAATATAGGCCCA|GTCCTGGTTGAATTAGAGAAGAATATTGTT
ACCGGCTAAATAGGTCACGTGCGTGCATGC|CATACATGTCCTGGTTTTTTAAAATAACAC
CTGTCGCCGGCGAAATTTACGTCGAGCTCT|CCGTGTCGCTATCACATACATGTCCTGGTT
CGGTCGAGCTTAGCGACGGGACAGTTATTT|CGCTATCACATACATGTCCTGGTTGAGTCG
ACTGGCTTTCCAGCGAACAGGCAAAATTCA|TAATCTGGCAAGCGTATCAGTTCCCCTTTA
TGGCAAGCGTATCAGTTCCCCTTTAAACCA|GTCCTGGTTTACCCTGGCACTTTGCTCCAT
AATTCACTAACCGTGTCGCTATCACATACA|CCTTTAAACCAAGCGGACGCCCTGGCAATA
TGTCGCTATCACATACATGTCCTGGTTGAG|ATCTCTTTTAGCTCGAAGCAAAAACCTACT
CGAACCTGCACGGAAATACCGATCAGCGGC|ATACAGATGCCCAACAATAATTCCGCAATA
AGGAGTCGCGCTGGATTAGAGCTCCGGACA|AACAGTCCGTGTCGCTATCACCCGTGTCGC
ACAGGGTGTGATCTTGATTATGCAGAGGGA|GGGTAAGGACGGTCGAGCTTAGCGACGGGA
ATTCTTACTTCCGTGAACCTGAAATAATGT|CAAAATTCACTAACCGTGTCGCTATCACAT
ATCACATACATGTCCTGGTTTGGATATCCA|CACAGCAAGGATAAGGTTGCGGACCTCTGA
TAAATAGGTCACGTGCGTGCATGCCGTAAC|TGTCCTGGTTTTTTAAAATAACACCGTGTC
AGATCACATCTCTTTTAGCTCGAAGCAAAA|AGAAGAAGGTAAGGAGTCGCGCTGGATTAG
ACGCCGTGTCGCTATCACATACATGTCCTG|GCTATCACATACATGTCCTGGTTTCCGACA
AGTTTACACCGTGTCGCTATCACATACATG|TGTCGCTATCACATACATGTCCTGGTTGTG
TCCCGCAGCCGAGACATTAGGGCTTAGTCC|TCGCTATCACATACATGTCCTGGTTGAATT
CATGTCCTGGTTGAGTCGCCCACCTGATCT|AAGCAAAAACCTACTTCCTTAACCGTGTGG
CAACTCGTTCAAGCACTCCAGTACTAGTTT|CATACATGTCCTGGTTGAAGTACCGTGTCG
CAATAATTCCGCAATACGTGTATCCACTCT|AGGCCCAGGCCCAGGCGTTGCCCCCGTGTC
GGTTATATCCCAATTCTTACTTCCGTGAAC|CCAGCGAACAGGCAAAATTCACTAACCGTG
TCACATACATGTCCTGGTTTCCGACATAAG|ATAATGTACGCTCTTCGGGGTAAACACTAC
CGCTCTTCGGGGTAAACACTACGTCCGTGT|CATGTCCTGGTTCAACGCCTAGATCACATC
GGTTTTTTAAAATAACACCGTGTCGCTATC|ATACATGTCCTGGTTTGGATATCCATCTTG
GTCCTGGTTTACCCTGGCACTTTGCTCCAT|TACATGTCCTGGTTAAGATCCGGTATGACA
CTATCACATACATGTCCTGGTTCAACGCCT|GCCCTGGCAATAACCCAAGATATTCTGGGA
CTTAGTCCCGCAAATATAGGCCCAGGCCCA|GTTGAATTAGAGAAGAATATTGTTCTTACA
CTGCGGTAGGATCCATGCTTGTCCGTGTCG|TTATATCCCAATTCTTACTTCCGTGAACCT
TTACGCCGTGTCGCTATCACATACATGTCC|TCGCTATCACATACATGTCCTGGTTTCCGA
CGTGTGGGCTCATTAATCTGGCAAGCGTAT|TGTCGCTATCACATACATGTCCTGGTTTAC
CCCGCAAATATAGGCCCAGGCCCAGGCGTT|TTAGAGAAGAATATTGTTCTTACAGTGCGG
TGCGTAAACAAGTTGATCGTTTTCCTAGGT|GCTATCACATACATGTCCTGGTTCAACTCG
TTACCGTGTCGCTATCACATACATGTCCTG|CGCCCACCTGATCTCGTTTGACTGGCTTTC
GGTTGAGTCGCCCACCTGATCTCGTTTGAC|ACCTACTTCCTTAACCGTGTGGGCTCATTA
CGTGTCGCTATCACATACATGTCCTGGTTT|TCACATACATGTCCTGGTTATACATGTCCT
GTTGATCGTTTTCCTAGGTCCACAGCAAGG|CATGTCCTGGTTCAACTCGTTCAAGCACTC
TAAGATCCGGTATGACACCCGTGTCGCTAT|TGAAGTTAGTGTGGCGGCGATAGGTATGAC
GATACAGATGCCCAACAATAATTCCGCAAT|TAGTCCCGCAAATATAGGCCCAGGCCCAGG
ATACAGATGCCCAACAATAATTCCGCAATA|AGTCCCGCAAATATAGGCCCAGGCCCAGGC
GGACTAGCCACCGCTGTCGCCGGCGAAATT|GGACAGTTATTTACCGTGTCGCTATCACAT
GGGGTAAACACTACGTCCGTGTCGCTATCA|GGTTCAACGCCTAGATCACATCTCTTTTAG
CGTTTTCCTAGGTCCACAGCAAGGATAAGG|CTGGTTCAACTCGTTCAAGCACTCCAGTAC
CCGTGTCGCTATCACATACATGTCCTGGTT|GATATCCATCTTGCGAGTGCACTGTGGACA
GTGTCGCTATCACATACATGTCCTGGTTCA|GACGTCGCTACCTTCCGTGTCGCTATCACA
GAACCTGAAATAATGTACGCTCTTCGGGGT|CGTGTCGCTATCACATACATGTCCTGGTTC
TTGGATATCCATCTTGCGAGTGCACTGTGG|CGGACCTCTGATCCCGCAGCCGAGACATTA
TCCGTGAACCTGAAATAATGTACGCTCTTC|CTAACCGTGTCGCTATCACATACATGTCCT
ACATACATGTCCTGGTTTACCCTGGCACTT|CCTGGTTATACATGTCCTGGTTAAGATCCG
GGACATCCGTGTCGCTATCACATACATGTC|GTCGCTATCACATACATGTCCTGGTTATAC
AAAATAACACCGTGTCGCTATCACATACAT|CCTGGTTTGGATATCCATCTTGCGAGTGCA
CACATACATGTCCTGGTTGAGTCGCCCACC|AGCTCGAAGCAAAAACCTACTTCCTTAACC
CGCCCTGGCAATAACCCAAGATATTCTGGG|CCGGGACAAACCGGCTAAATAGGTCACGTG
AGTTGATCGTTTTCCTAGGTCCACAGCAAG|ACATGTCCTGGTTCAACTCGTTCAAGCACT
TGGTTGAGTCGCCCACCTGATCTCGTTTGA|AACCTACTTCCTTAACCGTGTGGGCTCATT
ACCGTGTCGCTATCACATACATGTCCTGGT|TTTCCTAGGTCCACAGCAAGGATAAGGTTG
ATGCCGTAACAGTCCGTGTCGCTATCACCC|ACACCGTGTCGCTATCACATACATGTCCTG
ACACTACGTCCGTGTCGCTATCACATACAT|CGCCTAGATCACATCTCTTTTAGCTCGAAG
CTCTGCGGTAGGATCCATGCTTGTCCGTGT|GGTTATATCCCAATTCTTACTTCCGTGAAC
AAATATAGGCCCAGGCCCAGGCGTTGCCCC|GAAGAATATTGTTCTTACAGTGCGGCGAGC
AGACATTAGGGCTTAGTCCCGCAAATATAG|TACATGTCCTGGTTGAATTAGAGAAGAATA
CTATCACATACATGTCCTGGTTGAGTCGCC|TTTTAGCTCGAAGCAAAAACCTACTTCCTT
TATCACGTGTCGGCTACTTACGCCGTGTCG|ATCCATGCTTGTCCGTGTCGCTATCACATA
ATTAGGGCTTAGTCCCGCAAATATAGGCCC|TGTCCTGGTTGAATTAGAGAAGAATATTGT
TGGTTTCCGACATAAGGGTAAGGACGGTCG|TCGGGGTAAACACTACGTCCGTGTCGCTAT
GACTAGCCACCGCTGTCGCCGGCGAAATTT|GACAGTTATTTACCGTGTCGCTATCACATA
ACATCTCTTTTAGCTCGAAGCAAAAACCTA|AAGGTAAGGAGTCGCGCTGGATTAGAGCTC
GGGCTCATTAATCTGGCAAGCGTATCAGTT|CTATCACATACATGTCCTGGTTTACCCTGG
AAATAGGTCACGTGCGTGCATGCCGTAACA|GTCCTGGTTTTTTAAAATAACACCGTGTCG
GTCGCTATCACATACATGTCCTGGTTACAG|CATACATGTCCTGGTTTCCGACATAAGGGT
ATCACATACATGTCCTGGTTTAGCGAACCT|TTGCGAGTGCACTGTGGACAGAGATACAGA
TCCTGGTTGAGTCGCCCACCTGATCTCGTT|AAAAACCTACTTCCTTAACCGTGTGGGCTC
GTCGCTATCACATACATGTCCTGGTTCAAC|GGACGCCCTGGCAATAACCCAAGATATTCT
AGCACTCCAGTACTAGTTTACACCGTGTCG|TGGTTGAAGTACCGTGTCGCTATCACATAC
ATGAAGTTAGTGTGGCGGCGATAGGTATGA|ATCCACTCTTGCGTAAACAAGTTGATCGTT
GGTTCAACTCGTTCAAGCACTCCAGTACTA|ATCACATACATGTCCTGGTTGAAGTACCGT
AACAAGTTGATCGTTTTCCTAGGTCCACAG|ACATACATGTCCTGGTTCAACTCGTTCAAG
AAGGTTGCGGACCTCTGATCCCGCAGCCGA|GTACTAGTTTACACCGTGTCGCTATCACAT
CTTTGCTCCATCGCGCCCCGGGACAAACCG|CCGGTATGACACCCGTGTCGCTATCACATA
AAACACTACGTCCGTGTCGCTATCACATAC|AACGCCTAGATCACATCTCTTTTAGCTCGA
AATGTACGCTCTTCGGGGTAAACACTACGT|CACATACATGTCCTGGTTCAACGCCTAGAT
CGCTATCACATACATGTCCTGGTTATACAT|AGCGAACCTGCACGGAAATACCGATCAGCG
TCTGATCCCGCAGCCGAGACATTAGGGCTT|CCGTGTCGCTATCACATACATGTCCTGGTT
TACATGTCCTGGTTTAGCGAACCTGCACGG|GTGCACTGTGGACAGAGATACAGATGCCCA
GCCGTAACAGTCCGTGTCGCTATCACCCGT|ACCGTGTCGCTATCACATACATGTCCTGGT
CGCTATCACATACATGTCCTGGTTTAGCGA|CATCTTGCGAGTGCACTGTGGACAGAGATA
CCCGGGACAAACCGGCTAAATAGGTCACGT|GTCGCTATCACATACATGTCCTGGTTTTTT
CGAGTGCACTGTGGACAGAGATACAGATGC|CAGCCGAGACATTAGGGCTTAGTCCCGCAA
CGATCAGCGGCAAAGCATGAAGTTAGTGTG|ATTCCGCAATACGTGTATCCACTCTTGCGT
GCGGCGATAGGTATGACCGTGTCGCTATCA|AAACAAGTTGATCGTTTTCCTAGGTCCACA
TATGCAGAGGGACTAGCCACCGCTGTCGCC|TTAGCGACGGGACAGTTATTTACCGTGTCG
CCTGGTTAAGATCCGGTATGACACCCGTGT|AAAGCATGAAGTTAGTGTGGCGGCGATAGG
CCTGGTTTGGATATCCATCTTGCGAGTGCA|AGGTTGCGGACCTCTGATCCCGCAGCCGAG
GCTATCACATACATGTCCTGGTTACAGGGT|ACATGTCCTGGTTTCCGACATAAGGGTAAG
CCTAGGTCCACAGCAAGGATAAGGTTGCGG|CAACTCGTTCAAGCACTCCAGTACTAGTTT
GCTATCACATACATGTCCTGGTTTACCCTG|ACATGTCCTGGTTATACATGTCCTGGTTAA
ACATGTCCTGGTTTGGATATCCATCTTGCG|AGGATAAGGTTGCGGACCTCTGATCCCGCA
AGGTATGACCGTGTCGCTATCACATACATG|TGATCGTTTTCCTAGGTCCACAGCAAGGAT
GGCGAAATTTACGTCGAGCTCTGCGGTAGG|CTATCACATACATGTCCTGGTTATATCCCA
CGAGCTCTGCGGTAGGATCCATGCTTGTCC|TCCTGGTTATATCCCAATTCTTACTTCCGT
TATCCATCTTGCGAGTGCACTGTGGACAGA|CTCTGATCCCGCAGCCGAGACATTAGGGCT
ACATACATGTCCTGGTTTCCGACATAAGGG|AATGTACGCTCTTCGGGGTAAACACTACGT
CATCTCTTTTAGCTCGAAGCAAAAACCTAC|AGGTAAGGAGTCGCGCTGGATTAGAGCTCC
CATCTTGCGAGTGCACTGTGGACAGAGATA|GATCCCGCAGCCGAGACATTAGGGCTTAGT
CACGTGCGTGCATGCCGTAACAGTCCGTGT|TTTTTAAAATAACACCGTGTCGCTATCACA
TGTCCTGGTTACAGGGTGTGATCTTGATTA|TCCGACATAAGGGTAAGGACGGTCGAGCTT
CCCAGGCCCAGGCGTTGCCCCCGTGTCGCT|TGTTCTTACAGTGCGGCGAGCCGACGTCGC
CGGCGAAATTTACGTCGAGCTCTGCGGTAG|GCTATCACATACATGTCCTGGTTATATCCC
CAACAATAATTCCGCAATACGTGTATCCAC|TATAGGCCCAGGCCCAGGCGTTGCCCCCGT
TGTCCGTGTCGCTATCACATACATGTCCTG|TCCGTGAACCTGAAATAATGTACGCTCTTC
CAGTATCACGTGTCGGCTACTTACGCCGTG|AGGATCCATGCTTGTCCGTGTCGCTATCAC
GCTATCACATACATGTCCTGGTTGAGTCGC|CTTTTAGCTCGAAGCAAAAACCTACTTCCT
GCTAAATAGGTCACGTGCGTGCATGCCGTA|CATGTCCTGGTTTTTTAAAATAACACCGTG
CACATCTCTTTTAGCTCGAAGCAAAAACCT|GAAGGTAAGGAGTCGCGCTGGATTAGAGCT
AAAATTCACTAACCGTGTCGCTATCACATA|CCCCTTTAAACCAAGCGGACGCCCTGGCAA
CACATACATGTCCTGGTTATATCCCAATTC|GTTTGACTGGCTTTCCAGCGAACAGGCAAA
ATCACATACATGTCCTGGTTCAACGCCTAG|CCTGGCAATAACCCAAGATATTCTGGGAAG
TTAGCGAACCTGCACGGAAATACCGATCAG|AGAGATACAGATGCCCAACAATAATTCCGC
CTGGATTAGAGCTCCGGACATCCGTGTCGC|GTCGCTATCACCCGTGTCGCTATCACATAC
CAGGCAGTATCACGTGTCGGCTACTTACGC|CGGTAGGATCCATGCTTGTCCGTGTCGCTA
CGCCGTGTCGCTATCACATACATGTCCTGG|CTATCACATACATGTCCTGGTTTCCGACAT
GGCAATAACCCAAGATATTCTGGGAAGAAG|CAAACCGGCTAAATAGGTCACGTGCGTGCA
CGCCGGCGAAATTTACGTCGAGCTCTGCGG|GTCGCTATCACATACATGTCCTGGTTATAT
ATGACCGTGTCGCTATCACATACATGTCCT|CGTTTTCCTAGGTCCACAGCAAGGATAAGG
CACCCGTGTCGCTATCACATACATGTCCTG|GGCGATAGGTATGACCGTGTCGCTATCACA
TTACACCGTGTCGCTATCACATACATGTCC|CGCTATCACATACATGTCCTGGTTGTGAGT
TCCATCTTGCGAGTGCACTGTGGACAGAGA|CTGATCCCGCAGCCGAGACATTAGGGCTTA
AGCGAACAGGCAAAATTCACTAACCGTGTC|GCGTATCAGTTCCCCTTTAAACCAAGCGGA
GTTCAACGCCTAGATCACATCTCTTTTAGC|ATATTCTGGGAAGAAGAAGGTAAGGAGTCG
GTATTGCAGGCAGTATCACGTGTCGGCTAC|GCTCTGCGGTAGGATCCATGCTTGTCCGTG
CCTGGTTCAACTCGTTCAAGCACTCCAGTA|GCTATCACATACATGTCCTGGTTGAAGTAC
TCGCTATCACATACATGTCCTGGTTTGGAT|AGGTCCACAGCAAGGATAAGGTTGCGGACC
GTGTCGCTATCACATACATGTCCTGGTTCA|GCGGACGCCCTGGCAATAACCCAAGATATT
GTCCCGCAAATATAGGCCCAGGCCCAGGCG|AATTAGAGAAGAATATTGTTCTTACAGTGC
CATGTCCTGGTTTTTTAAAATAACACCGTG|GCTATCACATACATGTCCTGGTTTGGATAT
CGTGTCGCTATCACATACATGTCCTGGTTA|CACCTGATCTCGTTTGACTGGCTTTCCAGC
ATCAGTTCCCCTTTAAACCAAGCGGACGCC|ACCCTGGCACTTTGCTCCATCGCGCCCCGG
GTTATTTACCGTGTCGCTATCACATACATG|TGAGTCGCCCACCTGATCTCGTTTGACTGG
CTGGTTTCCGACATAAGGGTAAGGACGGTC|TTCGGGGTAAACACTACGTCCGTGTCGCTA
TTCATCCGGTATTGCAGGCAGTATCACGTG|TACGTCGAGCTCTGCGGTAGGATCCATGCT
CATGTCCTGGTTTACCCTGGCACTTTGCTC|TTATACATGTCCTGGTTAAGATCCGGTATG
TTTACGTCGAGCTCTGCGGTAGGATCCATG|ATACATGTCCTGGTTATATCCCAATTCTTA
ATACCGATCAGCGGCAAAGCATGAAGTTAG|AATAATTCCGCAATACGTGTATCCACTCTT
TTTGGATATCCATCTTGCGAGTGCACTGTG|GCGGACCTCTGATCCCGCAGCCGAGACATT
AATTCCGCAATACGTGTATCCACTCTTGCG|CCAGGCCCAGGCGTTGCCCCCGTGTCGCTA
TAGATCACATCTCTTTTAGCTCGAAGCAAA|AAGAAGAAGGTAAGGAGTCGCGCTGGATTA
CCGTGTCGCTATCACATACATGTCCTGGTT|AAGCGGACGCCCTGGCAATAACCCAAGATA
ATGTCCTGGTTATATCCCAATTCTTACTTC|TGGCTTTCCAGCGAACAGGCAAAATTCACT
TTCCAGCGAACAGGCAAAATTCACTAACCG|GCAAGCGTATCAGTTCCCCTTTAAACCAAG
TATCACATACATGTCCTGGTTTAGCGAACC|CTTGCGAGTGCACTGTGGACAGAGATACAG
CCGCAAATATAGGCCCAGGCCCAGGCGTTG|TAGAGAAGAATATTGTTCTTACAGTGCGGC
CCATGCTTGTCCGTGTCGCTATCACATACA|TCTTACTTCCGTGAACCTGAAATAATGTAC
TCCGTGTCGCTATCACATACATGTCCTGGT|TATCACATACATGTCCTGGTTATACATGTC
TCACATACATGTCCTGGTTATATCCCAATT|CGTTTGACTGGCTTTCCAGCGAACAGGCAA
ACTCGTTCAAGCACTCCAGTACTAGTTTAC|TACATGTCCTGGTTGAAGTACCGTGTCGCT
AACCTACTTCCTTAACCGTGTGGGCTCATT|GAGCTCCGGACATCCGTGTCGCTATCACAT
GTTTGGATATCCATCTTGCGAGTGCACTGT|TGCGGACCTCTGATCCCGCAGCCGAGACAT
TCCTGGTTACAGGGTGTGATCTTGATTATG|CGACATAAGGGTAAGGACGGTCGAGCTTAG
TCTTTTAGCTCGAAGCAAAAACCTACTTCC|AAGGAGTCGCGCTGGATTAGAGCTCCGGAC
ATACATGTCCTGGTTTACCCTGGCACTTTG|TGGTTATACATGTCCTGGTTAAGATCCGGT
AATAACCCAAGATATTCTGGGAAGAAGAAG|ACCGGCTAAATAGGTCACGTGCGTGCATGC
GGGTGTGATCTTGATTATGCAGAGGGACTA|TAAGGACGGTCGAGCTTAGCGACGGGACAG
GCTATCACATACATGTCCTGGTTTAGCGAA|ATCTTGCGAGTGCACTGTGGACAGAGATAC
TAGGTATGACCGTGTCGCTATCACATACAT|TTGATCGTTTTCCTAGGTCCACAGCAAGGA
GGCTTAGTCCCGCAAATATAGGCCCAGGCC|TGGTTGAATTAGAGAAGAATATTGTTCTTA
TGATCTCGTTTGACTGGCTTTCCAGCGAAC|GTGTGGGCTCATTAATCTGGCAAGCGTATC
CCACCGCTGTCGCCGGCGAAATTTACGTCG|TATTTACCGTGTCGCTATCACATACATGTC
TCGCCCACCTGATCTCGTTTGACTGGCTTT|TCCTTAACCGTGTGGGCTCATTAATCTGGC
TTCCTTAACCGTGTGGGCTCATTAATCTGG|GGACATCCGTGTCGCTATCACATACATGTC
CGCTATCACATACATGTCCTGGTTTCCGAC|CTGAAATAATGTACGCTCTTCGGGGTAAAC
ATGTCCTGGTTATACATGTCCTGGTTAAGA|GGAAATACCGATCAGCGGCAAAGCATGAAG
CTGGTTCAACTCGTTCAAGCACTCCAGTAC|CTATCACATACATGTCCTGGTTGAAGTACC
TCGCTATCACATACATGTCCTGGTTTCCGA|CCTGAAATAATGTACGCTCTTCGGGGTAAA
GTTTAGCGAACCTGCACGGAAATACCGATC|ACAGAGATACAGATGCCCAACAATAATTCC
GTCCTGGTTTTTTAAAATAACACCGTGTCG|ATCACATACATGTCCTGGTTTGGATATCCA
GCTGGATTAGAGCTCCGGACATCCGTGTCG|TGTCGCTATCACCCGTGTCGCTATCACATA
GCTTTCCAGCGAACAGGCAAAATTCACTAA|CTGGCAAGCGTATCAGTTCCCCTTTAAACC
TGTCCTGGTTCAACGCCTAGATCACATCTC|ACCCAAGATATTCTGGGAAGAAGAAGGTAA
CTATCACATACATGTCCTGGTTGAATTAGA|ATGTCCTGGTTGTGAGTTAACTATCAAGCC
TAGTCCCGCAAATATAGGCCCAGGCCCAGG|TGAATTAGAGAAGAATATTGTTCTTACAGT
ATGCAGAGGGACTAGCCACCGCTGTCGCCG|TAGCGACGGGACAGTTATTTACCGTGTCGC
CATGTCCTGGTTAAGATCCGGTATGACACC|GCGGCAAAGCATGAAGTTAGTGTGGCGGCG
TGGCACTTTGCTCCATCGCGCCCCGGGACA|AAGATCCGGTATGACACCCGTGTCGCTATC
ATCACATACATGTCCTGGTTTACCCTGGCA|TGTCCTGGTTATACATGTCCTGGTTAAGAT
TAGCCACCGCTGTCGCCGGCGAAATTTACG|AGTTATTTACCGTGTCGCTATCACATACAT
TGTCCTGGTTGAATTAGAGAAGAATATTGT|TGAGTTAACTATCAAGCCGTTCTACCGCGC
CCTGGCAATAACCCAAGATATTCTGGGAAG|GGACAAACCGGCTAAATAGGTCACGTGCGT
GCGGACCTCTGATCCCGCAGCCGAGACATT|GTTTACACCGTGTCGCTATCACATACATGT
CATGTCCTGGTTGAATTAGAGAAGAATATT|TGTGAGTTAACTATCAAGCCGTTCTACCGC
AACAATAATTCCGCAATACGTGTATCCACT|ATAGGCCCAGGCCCAGGCGTTGCCCCCGTG
GTCGCTATCACATACATGTCCTGGTTGAGT|TCTCTTTTAGCTCGAAGCAAAAACCTACTT
CAAATATAGGCCCAGGCCCAGGCGTTGCCC|AGAAGAATATTGTTCTTACAGTGCGGCGAG
TTGCTCCATCGCGCCCCGGGACAAACCGGC|GGTATGACACCCGTGTCGCTATCACATACA
CAGGCAAAATTCACTAACCGTGTCGCTATC|CAGTTCCCCTTTAAACCAAGCGGACGCCCT
GGTTAAGATCCGGTATGACACCCGTGTCGC|GCATGAAGTTAGTGTGGCGGCGATAGGTAT
CACATACATGTCCTGGTTTACCCTGGCACT|TCCTGGTTATACATGTCCTGGTTAAGATCC
CAGCGGCAAAGCATGAAGTTAGTGTGGCGG|CGCAATACGTGTATCCACTCTTGCGTAAAC
AGGATAAGGTTGCGGACCTCTGATCCCGCA|CTCCAGTACTAGTTTACACCGTGTCGCTAT
TTTGCTCCATCGCGCCCCGGGACAAACCGG|CGGTATGACACCCGTGTCGCTATCACATAC
AAGAAGAAGGTAAGGAGTCGCGCTGGATTA|CGTGCATGCCGTAACAGTCCGTGTCGCTAT
ATACATGTCCTGGTTTCCGACATAAGGGTA|TGTACGCTCTTCGGGGTAAACACTACGTCC
GTCGCCGGCGAAATTTACGTCGAGCTCTGC|GTGTCGCTATCACATACATGTCCTGGTTAT
GTAAACACTACGTCCGTGTCGCTATCACAT|TCAACGCCTAGATCACATCTCTTTTAGCTC
TCCGGACATCCGTGTCGCTATCACATACAT|CGTGTCGCTATCACATACATGTCCTGGTTA
ATACATGTCCTGGTTGAGTCGCCCACCTGA|TCGAAGCAAAAACCTACTTCCTTAACCGTG
GCGTATCAGTTCCCCTTTAAACCAAGCGGA|GTTTACCCTGGCACTTTGCTCCATCGCGCC
GATCCCGCAGCCGAGACATTAGGGCTTAGT|TGTCGCTATCACATACATGTCCTGGTTGAA
CCCACCTGATCTCGTTTGACTGGCTTTCCA|TTAACCGTGTGGGCTCATTAATCTGGCAAG
CATACATGTCCTGGTTATATCCCAATTCTT|TTGACTGGCTTTCCAGCGAACAGGCAAAAT
GGCGATAGGTATGACCGTGTCGCTATCACA|ACAAGTTGATCGTTTTCCTAGGTCCACAGC
GGCGTTGCCCCCGTGTCGCTATCACATACA|GTGCGGCGAGCCGACGTCGCTACCTTCCGT
ATGTCCTGGTTAAGATCCGGTATGACACCC|CGGCAAAGCATGAAGTTAGTGTGGCGGCGA
GCGAACAGGCAAAATTCACTAACCGTGTCG|CGTATCAGTTCCCCTTTAAACCAAGCGGAC
TCCATCGCGCCCCGGGACAAACCGGCTAAA|TGACACCCGTGTCGCTATCACATACATGTC
GTCCTGGTTATACATGTCCTGGTTAAGATC|AAATACCGATCAGCGGCAAAGCATGAAGTT
ACTAACCGTGTCGCTATCACATACATGTCC|AAACCAAGCGGACGCCCTGGCAATAACCCA
TCGCTATCACATACATGTCCTGGTTATACA|TAGCGAACCTGCACGGAAATACCGATCAGC
ACCTCTGATCCCGCAGCCGAGACATTAGGG|ACACCGTGTCGCTATCACATACATGTCCTG
CAACGCCTAGATCACATCTCTTTTAGCTCG|TTCTGGGAAGAAGAAGGTAAGGAGTCGCGC
ATATCCCAATTCTTACTTCCGTGAACCTGA|CGAACAGGCAAAATTCACTAACCGTGTCGC
GGCAGTATCACGTGTCGGCTACTTACGCCG|GTAGGATCCATGCTTGTCCGTGTCGCTATC
CTTGCGAGTGCACTGTGGACAGAGATACAG|CCCGCAGCCGAGACATTAGGGCTTAGTCCC
GGCAAAATTCACTAACCGTGTCGCTATCAC|GTTCCCCTTTAAACCAAGCGGACGCCCTGG
GCTTGTCCGTGTCGCTATCACATACATGTC|ACTTCCGTGAACCTGAAATAATGTACGCTC
CCCAAGATATTCTGGGAAGAAGAAGGTAAG|CTAAATAGGTCACGTGCGTGCATGCCGTAA
TTGACTGGCTTTCCAGCGAACAGGCAAAAT|CATTAATCTGGCAAGCGTATCAGTTCCCCT
TGTCCTGGTTTCCGACATAAGGGTAAGGAC|GCTCTTCGGGGTAAACACTACGTCCGTGTC
GCCCTGGCAATAACCCAAGATATTCTGGGA|CGGGACAAACCGGCTAAATAGGTCACGTGC
ATGTCCTGGTTACAGGGTGTGATCTTGATT|TTCCGACATAAGGGTAAGGACGGTCGAGCT
CAAGCGTATCAGTTCCCCTTTAAACCAAGC|CTGGTTTACCCTGGCACTTTGCTCCATCGC
GTCCTGGTTATATCCCAATTCTTACTTCCG|GCTTTCCAGCGAACAGGCAAAATTCACTAA
GGCTTTCCAGCGAACAGGCAAAATTCACTA|TCTGGCAAGCGTATCAGTTCCCCTTTAAAC
AGAAGGTAAGGAGTCGCGCTGGATTAGAGC|CATGCCGTAACAGTCCGTGTCGCTATCACC
AAGCAAAAACCTACTTCCTTAACCGTGTGG|TGGATTAGAGCTCCGGACATCCGTGTCGCT
ACGCCTAGATCACATCTCTTTTAGCTCGAA|CTGGGAAGAAGAAGGTAAGGAGTCGCGCTG
ATCCGGTATTGCAGGCAGTATCACGTGTCG|GTCGAGCTCTGCGGTAGGATCCATGCTTGT
CCATCTTGCGAGTGCACTGTGGACAGAGAT|TGATCCCGCAGCCGAGACATTAGGGCTTAG
GTCGCTATCACATACATGTCCTGGTTTCCG|ACCTGAAATAATGTACGCTCTTCGGGGTAA
CAGATGCCCAACAATAATTCCGCAATACGT|CCCGCAAATATAGGCCCAGGCCCAGGCGTT
TACGTCCGTGTCGCTATCACATACATGTCC|TAGATCACATCTCTTTTAGCTCGAAGCAAA
TGATCGTTTTCCTAGGTCCACAGCAAGGAT|TGTCCTGGTTCAACTCGTTCAAGCACTCCA
CCAGGCCCAGGCGTTGCCCCCGTGTCGCTA|GTTCTTACAGTGCGGCGAGCCGACGTCGCT
ACATGTCCTGGTTTCCGACATAAGGGTAAG|TACGCTCTTCGGGGTAAACACTACGTCCGT
TATCACATACATGTCCTGGTTCAACGCCTA|CCCTGGCAATAACCCAAGATATTCTGGGAA
TTTGACTGGCTTTCCAGCGAACAGGCAAAA|TCATTAATCTGGCAAGCGTATCAGTTCCCC
ACGTCCGTGTCGCTATCACATACATGTCCT|AGATCACATCTCTTTTAGCTCGAAGCAAAA
GTCCTGGTTACAGGGTGTGATCTTGATTAT|CCGACATAAGGGTAAGGACGGTCGAGCTTA
GTCGCTATCACATACATGTCCTGGTTTAGC|TCCATCTTGCGAGTGCACTGTGGACAGAGA
CAGTCCGTGTCGCTATCACCCGTGTCGCTA|CGCTATCACATACATGTCCTGGTTTAGCGA
TTTAAACCAAGCGGACGCCCTGGCAATAAC|TTGCTCCATCGCGCCCCGGGACAAACCGGC
TCGCTATCACATACATGTCCTGGTTGAGTC|CTCTTTTAGCTCGAAGCAAAAACCTACTTC
TTACTTCCGTGAACCTGAAATAATGTACGC|ATTCACTAACCGTGTCGCTATCACATACAT
CATACATGTCCTGGTTTAGCGAACCTGCAC|GAGTGCACTGTGGACAGAGATACAGATGCC
TACATGTCCTGGTTCAACGCCTAGATCACA|AATAACCCAAGATATTCTGGGAAGAAGAAG
CCCCCGTGTCGCTATCACATACATGTCCTG|GAGCCGACGTCGCTACCTTCCGTGTCGCTA
AGTGCACTGTGGACAGAGATACAGATGCCC|GCCGAGACATTAGGGCTTAGTCCCGCAAAT
CGAAGCAAAAACCTACTTCCTTAACCGTGT|GCTGGATTAGAGCTCCGGACATCCGTGTCG
ACATGTCCTGGTTCAACTCGTTCAAGCACT|CGTGTCGCTATCACATACATGTCCTGGTTG
TATCACATACATGTCCTGGTTACAGGGTGT|ATGTCCTGGTTTCCGACATAAGGGTAAGGA
GACCTCTGATCCCGCAGCCGAGACATTAGG|TACACCGTGTCGCTATCACATACATGTCCT
GGTTTCCGACATAAGGGTAAGGACGGTCGA|CGGGGTAAACACTACGTCCGTGTCGCTATC
CGTAAACAAGTTGATCGTTTTCCTAGGTCC|TATCACATACATGTCCTGGTTCAACTCGTT
AAGCGTATCAGTTCCCCTTTAAACCAAGCG|TGGTTTACCCTGGCACTTTGCTCCATCGCG
GGTTCAACGCCTAGATCACATCTCTTTTAG|GATATTCTGGGAAGAAGAAGGTAAGGAGTC
CGCTATCACATACATGTCCTGGTTGAGTCG|TCTTTTAGCTCGAAGCAAAAACCTACTTCC
ACATACATGTCCTGGTTCAACGCCTAGATC|GGCAATAACCCAAGATATTCTGGGAAGAAG
CTGGTTATATCCCAATTCTTACTTCCGTGA|TTCCAGCGAACAGGCAAAATTCACTAACCG
TCAGTTCCCCTTTAAACCAAGCGGACGCCC|CCCTGGCACTTTGCTCCATCGCGCCCCGGG
AACAGGCAAAATTCACTAACCGTGTCGCTA|ATCAGTTCCCCTTTAAACCAAGCGGACGCC
GAGGGACTAGCCACCGCTGTCGCCGGCGAA|ACGGGACAGTTATTTACCGTGTCGCTATCA
TCACATACATGTCCTGGTTTGGATATCCAT|ACAGCAAGGATAAGGTTGCGGACCTCTGAT
CGAGCTTAGCGACGGGACAGTTATTTACCG|ATCACATACATGTCCTGGTTGAGTCGCCCA
TTGCGGACCTCTGATCCCGCAGCCGAGACA|TAGTTTACACCGTGTCGCTATCACATACAT
AGCATGAAGTTAGTGTGGCGGCGATAGGTA|TGTATCCACTCTTGCGTAAACAAGTTGATC
CATACATGTCCTGGTTGAATTAGAGAAGAA|TGGTTGTGAGTTAACTATCAAGCCGTTCTA
TGCCCCCGTGTCGCTATCACATACATGTCC|GCGAGCCGACGTCGCTACCTTCCGTGTCGC
GTCCACAGCAAGGATAAGGTTGCGGACCTC|CGTTCAAGCACTCCAGTACTAGTTTACACC
TTTCCGACATAAGGGTAAGGACGGTCGAGC|GGGTAAACACTACGTCCGTGTCGCTATCAC
CTGGTTTTTTAAAATAACACCGTGTCGCTA|ACATACATGTCCTGGTTTGGATATCCATCT
ACATACATGTCCTGGTTATATCCCAATTCT|TTTGACTGGCTTTCCAGCGAACAGGCAAAA
AGCGTATCAGTTCCCCTTTAAACCAAGCGG|GGTTTACCCTGGCACTTTGCTCCATCGCGC
TGGGAAGAAGAAGGTAAGGAGTCGCGCTGG|CGTGCGTGCATGCCGTAACAGTCCGTGTCG
GCCCCGGGACAAACCGGCTAAATAGGTCAC|GTGTCGCTATCACATACATGTCCTGGTTTT
GTCGAGCTTAGCGACGGGACAGTTATTTAC|CTATCACATACATGTCCTGGTTGAGTCGCC
GCAATAACCCAAGATATTCTGGGAAGAAGA|AAACCGGCTAAATAGGTCACGTGCGTGCAT
AGCTCGAAGCAAAAACCTACTTCCTTAACC|TCGCGCTGGATTAGAGCTCCGGACATCCGT
TGTCCTGGTTTACCCTGGCACTTTGCTCCA|ATACATGTCCTGGTTAAGATCCGGTATGAC
CGAACAGGCAAAATTCACTAACCGTGTCGC|GTATCAGTTCCCCTTTAAACCAAGCGGACG
CTATCACCCGTGTCGCTATCACATACATGT|CATGTCCTGGTTTAGCGAACCTGCACGGAA
TCCTGGTTTACCCTGGCACTTTGCTCCATC|ACATGTCCTGGTTAAGATCCGGTATGACAC
TGTCGCTATCACATACATGTCCTGGTTCAA|CGGACGCCCTGGCAATAACCCAAGATATTC
CCAGGCGTTGCCCCCGTGTCGCTATCACAT|ACAGTGCGGCGAGCCGACGTCGCTACCTTC
CGACATAAGGGTAAGGACGGTCGAGCTTAG|AAACACTACGTCCGTGTCGCTATCACATAC
GTTATACATGTCCTGGTTAAGATCCGGTAT|CGATCAGCGGCAAAGCATGAAGTTAGTGTG
ACGGGACAGTTATTTACCGTGTCGCTATCA|GTCCTGGTTGAGTCGCCCACCTGATCTCGT
ACTAGTTTACACCGTGTCGCTATCACATAC|CCGTGTCGCTATCACATACATGTCCTGGTT
TACCGATCAGCGGCAAAGCATGAAGTTAGT|ATAATTCCGCAATACGTGTATCCACTCTTG
ATAGTTGCATTTCATCCGGTATTGCAGGCA|CGGCGAAATTTACGTCGAGCTCTGCGGTAG
GCTATCACCCGTGTCGCTATCACATACATG|ACATGTCCTGGTTTAGCGAACCTGCACGGA
GTTCAAGCACTCCAGTACTAGTTTACACCG|TGTCCTGGTTGAAGTACCGTGTCGCTATCA
GGGACAGTTATTTACCGTGTCGCTATCACA|CCTGGTTGAGTCGCCCACCTGATCTCGTTT
CCGTGTCGCTATCACATACATGTCCTGGTT|CCACCTGATCTCGTTTGACTGGCTTTCCAG
CATACATGTCCTGGTTACAGGGTGTGATCT|CTGGTTTCCGACATAAGGGTAAGGACGGTC
CCTGGTTATACATGTCCTGGTTAAGATCCG|ATACCGATCAGCGGCAAAGCATGAAGTTAG
CATGTCCTGGTTTCCGACATAAGGGTAAGG|ACGCTCTTCGGGGTAAACACTACGTCCGTG
TCGTTTTCCTAGGTCCACAGCAAGGATAAG|CCTGGTTCAACTCGTTCAAGCACTCCAGTA
CCCAATTCTTACTTCCGTGAACCTGAAATA|CAGGCAAAATTCACTAACCGTGTCGCTATC
GCATGAAGTTAGTGTGGCGGCGATAGGTAT|GTATCCACTCTTGCGTAAACAAGTTGATCG
CTTAGCGACGGGACAGTTATTTACCGTGTC|CATACATGTCCTGGTTGAGTCGCCCACCTG
GTGAACCTGAAATAATGTACGCTCTTCGGG|ACCGTGTCGCTATCACATACATGTCCTGGT
CCGTGTGGGCTCATTAATCTGGCAAGCGTA|GTGTCGCTATCACATACATGTCCTGGTTTA
GTCGCTATCACATACATGTCCTGGTTTACC|CATACATGTCCTGGTTATACATGTCCTGGT
TGGATATCCATCTTGCGAGTGCACTGTGGA|GGACCTCTGATCCCGCAGCCGAGACATTAG
TTAATCTGGCAAGCGTATCAGTTCCCCTTT|ATACATGTCCTGGTTTACCCTGGCACTTTG
TCAAGCACTCCAGTACTAGTTTACACCGTG|TCCTGGTTGAAGTACCGTGTCGCTATCACA
CATAGTTGCATTTCATCCGGTATTGCAGGC|CCGGCGAAATTTACGTCGAGCTCTGCGGTA
ATTCTGGGAAGAAGAAGGTAAGGAGTCGCG|GTCACGTGCGTGCATGCCGTAACAGTCCGT
CAAGATATTCTGGGAAGAAGAAGGTAAGGA|AAATAGGTCACGTGCGTGCATGCCGTAACA
TCCATGCTTGTCCGTGTCGCTATCACATAC|TTCTTACTTCCGTGAACCTGAAATAATGTA
TGCGGACCTCTGATCCCGCAGCCGAGACAT|AGTTTACACCGTGTCGCTATCACATACATG
TGTGATCTTGATTATGCAGAGGGACTAGCC|GGACGGTCGAGCTTAGCGACGGGACAGTTA
TTTCCAGCGAACAGGCAAAATTCACTAACC|GGCAAGCGTATCAGTTCCCCTTTAAACCAA
GCGATAGGTATGACCGTGTCGCTATCACAT|CAAGTTGATCGTTTTCCTAGGTCCACAGCA
ATAAGGGTAAGGACGGTCGAGCTTAGCGAC|ACTACGTCCGTGTCGCTATCACATACATGT
GACAAACCGGCTAAATAGGTCACGTGCGTG|TATCACATACATGTCCTGGTTTTTTAAAAT
ACATGTCCTGGTTATATCCCAATTCTTACT|ACTGGCTTTCCAGCGAACAGGCAAAATTCA
CTATCACATACATGTCCTGGTTATACATGT|CGAACCTGCACGGAAATACCGATCAGCGGC
ACCGTGTCGCTATCACATACATGTCCTGGT|GGATATCCATCTTGCGAGTGCACTGTGGAC
CTGGGAAGAAGAAGGTAAGGAGTCGCGCTG|ACGTGCGTGCATGCCGTAACAGTCCGTGTC
GGATTAGAGCTCCGGACATCCGTGTCGCTA|CGCTATCACCCGTGTCGCTATCACATACAT
CCAGTACTAGTTTACACCGTGTCGCTATCA|AAGTACCGTGTCGCTATCACATACATGTCC
ACCGTGTCGCTATCACATACATGTCCTGGT|ATCACATACATGTCCTGGTTGTGAGTTAAC
TCATTAATCTGGCAAGCGTATCAGTTCCCC|CACATACATGTCCTGGTTTACCCTGGCACT
GGTCACGTGCGTGCATGCCGTAACAGTCCG|GGTTTTTTAAAATAACACCGTGTCGCTATC
GTCGCTATCACATACATGTCCTGGTTATAC|TTAGCGAACCTGCACGGAAATACCGATCAG
TCCGGTATGACACCCGTGTCGCTATCACAT|TTAGTGTGGCGGCGATAGGTATGACCGTGT
CTATCACATACATGTCCTGGTTCAACTCGT|GCTACCTTCCGTGTCGCTATCACATACATG
GAAGAAGAAGGTAAGGAGTCGCGCTGGATT|GCGTGCATGCCGTAACAGTCCGTGTCGCTA
ACCAAGCGGACGCCCTGGCAATAACCCAAG|CCATCGCGCCCCGGGACAAACCGGCTAAAT
ATCCCAATTCTTACTTCCGTGAACCTGAAA|AACAGGCAAAATTCACTAACCGTGTCGCTA
CGCTATCACATACATGTCCTGGTTGAATTA|ACATGTCCTGGTTGTGAGTTAACTATCAAG
GCGTGCATGCCGTAACAGTCCGTGTCGCTA|AAAATAACACCGTGTCGCTATCACATACAT
TTCGGGGTAAACACTACGTCCGTGTCGCTA|CCTGGTTCAACGCCTAGATCACATCTCTTT
TCCTGGTTTCCGACATAAGGGTAAGGACGG|TCTTCGGGGTAAACACTACGTCCGTGTCGC
CGGACGCCCTGGCAATAACCCAAGATATTC|CGCCCCGGGACAAACCGGCTAAATAGGTCA
GGACAAACCGGCTAAATAGGTCACGTGCGT|CTATCACATACATGTCCTGGTTTTTTAAAA
AAGTTGATCGTTTTCCTAGGTCCACAGCAA|TACATGTCCTGGTTCAACTCGTTCAAGCAC
CTTGATTATGCAGAGGGACTAGCCACCGCT|TCGAGCTTAGCGACGGGACAGTTATTTACC
ATCGTTTTCCTAGGTCCACAGCAAGGATAA|TCCTGGTTCAACTCGTTCAAGCACTCCAGT
CATTAGGGCTTAGTCCCGCAAATATAGGCC|ATGTCCTGGTTGAATTAGAGAAGAATATTG
GGGAAGAAGAAGGTAAGGAGTCGCGCTGGA|GTGCGTGCATGCCGTAACAGTCCGTGTCGC
TGCATGCCGTAACAGTCCGTGTCGCTATCA|ATAACACCGTGTCGCTATCACATACATGTC
GTCCTGGTTCAACTCGTTCAAGCACTCCAG|TCGCTATCACATACATGTCCTGGTTGAAGT
CACTCCAGTACTAGTTTACACCGTGTCGCT|GTTGAAGTACCGTGTCGCTATCACATACAT
TACAGATGCCCAACAATAATTCCGCAATAC|GTCCCGCAAATATAGGCCCAGGCCCAGGCG
GTGTATCCACTCTTGCGTAAACAAGTTGAT|TTGCCCCCGTGTCGCTATCACATACATGTC
CTAGATCACATCTCTTTTAGCTCGAAGCAA|GAAGAAGAAGGTAAGGAGTCGCGCTGGATT
CTCCATCGCGCCCCGGGACAAACCGGCTAA|ATGACACCCGTGTCGCTATCACATACATGT
GCGAACCTGCACGGAAATACCGATCAGCGG|GATACAGATGCCCAACAATAATTCCGCAAT
CTCTGATCCCGCAGCCGAGACATTAGGGCT|ACCGTGTCGCTATCACATACATGTCCTGGT
CACATACATGTCCTGGTTCAACTCGTTCAA|CCTTCCGTGTCGCTATCACATACATGTCCT
CGACGGGACAGTTATTTACCGTGTCGCTAT|ATGTCCTGGTTGAGTCGCCCACCTGATCTC
TACTAGTTTACACCGTGTCGCTATCACATA|ACCGTGTCGCTATCACATACATGTCCTGGT
ACATACATGTCCTGGTTTTTTAAAATAACA|GTGTCGCTATCACATACATGTCCTGGTTTG
CATTAATCTGGCAAGCGTATCAGTTCCCCT|ACATACATGTCCTGGTTTACCCTGGCACTT
CTGGTTATACATGTCCTGGTTAAGATCCGG|TACCGATCAGCGGCAAAGCATGAAGTTAGT
TTAGCTCGAAGCAAAAACCTACTTCCTTAA|AGTCGCGCTGGATTAGAGCTCCGGACATCC
GTCGGCTACTTACGCCGTGTCGCTATCACA|TTGTCCGTGTCGCTATCACATACATGTCCT
GCGAAATTTACGTCGAGCTCTGCGGTAGGA|TATCACATACATGTCCTGGTTATATCCCAA
CCTGGTTACAGGGTGTGATCTTGATTATGC|GACATAAGGGTAAGGACGGTCGAGCTTAGC
CCCGTGTCGCTATCACATACATGTCCTGGT|CGATAGGTATGACCGTGTCGCTATCACATA
CCTACTTCCTTAACCGTGTGGGCTCATTAA|GCTCCGGACATCCGTGTCGCTATCACATAC
ACCTGAAATAATGTACGCTCTTCGGGGTAA|TGTCGCTATCACATACATGTCCTGGTTCAA
GTATCAGTTCCCCTTTAAACCAAGCGGACG|TTACCCTGGCACTTTGCTCCATCGCGCCCC
CGTGTATCCACTCTTGCGTAAACAAGTTGA|GTTGCCCCCGTGTCGCTATCACATACATGT
ACGGTCGAGCTTAGCGACGGGACAGTTATT|TCGCTATCACATACATGTCCTGGTTGAGTC
GTTTACACCGTGTCGCTATCACATACATGT|GTCGCTATCACATACATGTCCTGGTTGTGA
GGCCCAGGCGTTGCCCCCGTGTCGCTATCA|CTTACAGTGCGGCGAGCCGACGTCGCTACC
TTCACTAACCGTGTCGCTATCACATACATG|TTTAAACCAAGCGGACGCCCTGGCAATAAC
AGAGATACAGATGCCCAACAATAATTCCGC|GCTTAGTCCCGCAAATATAGGCCCAGGCCC
GCATGCCGTAACAGTCCGTGTCGCTATCAC|TAACACCGTGTCGCTATCACATACATGTCC
TCCTAGGTCCACAGCAAGGATAAGGTTGCG|TCAACTCGTTCAAGCACTCCAGTACTAGTT
GGTATGACACCCGTGTCGCTATCACATACA|GTGTGGCGGCGATAGGTATGACCGTGTCGC
AACCGTGTGGGCTCATTAATCTGGCAAGCG|CCGTGTCGCTATCACATACATGTCCTGGTT
CGGACCTCTGATCCCGCAGCCGAGACATTA|TTTACACCGTGTCGCTATCACATACATGTC
TATAGGCCCAGGCCCAGGCGTTGCCCCCGT|GAATATTGTTCTTACAGTGCGGCGAGCCGA
GACATCCGTGTCGCTATCACATACATGTCC|TCGCTATCACATACATGTCCTGGTTATACA
ATGCTTGTCCGTGTCGCTATCACATACATG|TTACTTCCGTGAACCTGAAATAATGTACGC
TGACCGTGTCGCTATCACATACATGTCCTG|GTTTTCCTAGGTCCACAGCAAGGATAAGGT
GAGCTCCGGACATCCGTGTCGCTATCACAT|CACCCGTGTCGCTATCACATACATGTCCTG
CACTCTTGCGTAAACAAGTTGATCGTTTTC|CGTGTCGCTATCACATACATGTCCTGGTTC
TCACATACATGTCCTGGTTTAGCGAACCTG|TGCGAGTGCACTGTGGACAGAGATACAGAT
GCTCCATCGCGCCCCGGGACAAACCGGCTA|TATGACACCCGTGTCGCTATCACATACATG
CCTCTGATCCCGCAGCCGAGACATTAGGGC|CACCGTGTCGCTATCACATACATGTCCTGG
ATTGCAGGCAGTATCACGTGTCGGCTACTT|TCTGCGGTAGGATCCATGCTTGTCCGTGTC
TCTTGCGAGTGCACTGTGGACAGAGATACA|TCCCGCAGCCGAGACATTAGGGCTTAGTCC
CAATACGTGTATCCACTCTTGCGTAAACAA|CAGGCGTTGCCCCCGTGTCGCTATCACATA
AGAGGGACTAGCCACCGCTGTCGCCGGCGA|GACGGGACAGTTATTTACCGTGTCGCTATC
ACCCAAGATATTCTGGGAAGAAGAAGGTAA|GCTAAATAGGTCACGTGCGTGCATGCCGTA
ACATGTCCTGGTTCAACGCCTAGATCACAT|ATAACCCAAGATATTCTGGGAAGAAGAAGG
ACAGAGATACAGATGCCCAACAATAATTCC|GGGCTTAGTCCCGCAAATATAGGCCCAGGC
ATCTTGATTATGCAGAGGGACTAGCCACCG|GGTCGAGCTTAGCGACGGGACAGTTATTTA
CAAACCGGCTAAATAGGTCACGTGCGTGCA|TCACATACATGTCCTGGTTTTTTAAAATAA
CGGTAGGATCCATGCTTGTCCGTGTCGCTA|TATCCCAATTCTTACTTCCGTGAACCTGAA
CTGGCACTTTGCTCCATCGCGCCCCGGGAC|TAAGATCCGGTATGACACCCGTGTCGCTAT
TGGTTAAGATCCGGTATGACACCCGTGTCG|AGCATGAAGTTAGTGTGGCGGCGATAGGTA
ATCAGCGGCAAAGCATGAAGTTAGTGTGGC|TCCGCAATACGTGTATCCACTCTTGCGTAA
TAACCGTGTCGCTATCACATACATGTCCTG|ACCAAGCGGACGCCCTGGCAATAACCCAAG
CCCGCAGCCGAGACATTAGGGCTTAGTCCC|CGCTATCACATACATGTCCTGGTTGAATTA
GCACTCCAGTACTAGTTTACACCGTGTCGC|GGTTGAAGTACCGTGTCGCTATCACATACA
TGCGGTAGGATCCATGCTTGTCCGTGTCGC|TATATCCCAATTCTTACTTCCGTGAACCTG
GTTGCCCCCGTGTCGCTATCACATACATGT|CGGCGAGCCGACGTCGCTACCTTCCGTGTC
TGACTGGCTTTCCAGCGAACAGGCAAAATT|ATTAATCTGGCAAGCGTATCAGTTCCCCTT
GTGTCGCTATCACATACATGTCCTGGTTAC|CACATACATGTCCTGGTTTCCGACATAAGG
ACGTCGAGCTCTGCGGTAGGATCCATGCTT|CATGTCCTGGTTATATCCCAATTCTTACTT
GATCACATCTCTTTTAGCTCGAAGCAAAAA|GAAGAAGGTAAGGAGTCGCGCTGGATTAGA
GTTTTCCTAGGTCCACAGCAAGGATAAGGT|TGGTTCAACTCGTTCAAGCACTCCAGTACT
GGCTACTTACGCCGTGTCGCTATCACATAC|TCCGTGTCGCTATCACATACATGTCCTGGT
CTGGTTTACCCTGGCACTTTGCTCCATCGC|ATGTCCTGGTTAAGATCCGGTATGACACCC
GTCCTGGTTGAGTCGCCCACCTGATCTCGT|CAAAAACCTACTTCCTTAACCGTGTGGGCT
ACATACATGTCCTGGTTTGGATATCCATCT|AGCAAGGATAAGGTTGCGGACCTCTGATCC
CTGGTTTGGATATCCATCTTGCGAGTGCAC|GGTTGCGGACCTCTGATCCCGCAGCCGAGA
ATATTCTGGGAAGAAGAAGGTAAGGAGTCG|AGGTCACGTGCGTGCATGCCGTAACAGTCC
TGTCCTGGTTAAGATCCGGTATGACACCCG|GGCAAAGCATGAAGTTAGTGTGGCGGCGAT
GTGTGGGCTCATTAATCTGGCAAGCGTATC|GTCGCTATCACATACATGTCCTGGTTTACC
GGTCCACAGCAAGGATAAGGTTGCGGACCT|TCGTTCAAGCACTCCAGTACTAGTTTACAC
TGTCGCTATCACATACATGTCCTGGTTACA|ACATACATGTCCTGGTTTCCGACATAAGGG
TTGATTATGCAGAGGGACTAGCCACCGCTG|CGAGCTTAGCGACGGGACAGTTATTTACCG
CTGATCCCGCAGCCGAGACATTAGGGCTTA|CGTGTCGCTATCACATACATGTCCTGGTTG
AAGATCCGGTATGACACCCGTGTCGCTATC|GAAGTTAGTGTGGCGGCGATAGGTATGACC
GGGACTAGCCACCGCTGTCGCCGGCGAAAT|GGGACAGTTATTTACCGTGTCGCTATCACA
GCTCTGCGGTAGGATCCATGCTTGTCCGTG|TGGTTATATCCCAATTCTTACTTCCGTGAA
ATACATGTCCTGGTTGAATTAGAGAAGAAT|GGTTGTGAGTTAACTATCAAGCCGTTCTAC
AAACCGGCTAAATAGGTCACGTGCGTGCAT|CACATACATGTCCTGGTTTTTTAAAATAAC
TGTCGCCGGCGAAATTTACGTCGAGCTCTG|CGTGTCGCTATCACATACATGTCCTGGTTA
AATACCGATCAGCGGCAAAGCATGAAGTTA|CAATAATTCCGCAATACGTGTATCCACTCT
TGCACTGTGGACAGAGATACAGATGCCCAA|CGAGACATTAGGGCTTAGTCCCGCAAATAT
GTAACAGTCCGTGTCGCTATCACCCGTGTC|GTGTCGCTATCACATACATGTCCTGGTTTA
TCTGGCAAGCGTATCAGTTCCCCTTTAAAC|ATGTCCTGGTTTACCCTGGCACTTTGCTCC
TAGGCCCAGGCCCAGGCGTTGCCCCCGTGT|ATATTGTTCTTACAGTGCGGCGAGCCGACG
ACGCCCTGGCAATAACCCAAGATATTCTGG|CCCGGGACAAACCGGCTAAATAGGTCACGT
AAGGATAAGGTTGCGGACCTCTGATCCCGC|ACTCCAGTACTAGTTTACACCGTGTCGCTA
ATCACATACATGTCCTGGTTACAGGGTGTG|TGTCCTGGTTTCCGACATAAGGGTAAGGAC
CCCTGGCAATAACCCAAGATATTCTGGGAA|GGGACAAACCGGCTAAATAGGTCACGTGCG
CTAGCCACCGCTGTCGCCGGCGAAATTTAC|CAGTTATTTACCGTGTCGCTATCACATACA
GTGTCGCTATCACATACATGTCCTGGTTAT|GTTTAGCGAACCTGCACGGAAATACCGATC
TTTTAAAATAACACCGTGTCGCTATCACAT|ATGTCCTGGTTTGGATATCCATCTTGCGAG
AGGTCACGTGCGTGCATGCCGTAACAGTCC|TGGTTTTTTAAAATAACACCGTGTCGCTAT
ACCGTGTCGCTATCACATACATGTCCTGGT|CCCACCTGATCTCGTTTGACTGGCTTTCCA
ATCCACTCTTGCGTAAACAAGTTGATCGTT|CCCCGTGTCGCTATCACATACATGTCCTGG
TCACATACATGTCCTGGTTCAACGCCTAGA|CTGGCAATAACCCAAGATATTCTGGGAAGA
ACACCGTGTCGCTATCACATACATGTCCTG|TTGGATATCCATCTTGCGAGTGCACTGTGG
TGTGGACAGAGATACAGATGCCCAACAATA|CATTAGGGCTTAGTCCCGCAAATATAGGCC
CGTTGCCCCCGTGTCGCTATCACATACATG|GCGGCGAGCCGACGTCGCTACCTTCCGTGT
GTTTTTTAAAATAACACCGTGTCGCTATCA|TACATGTCCTGGTTTGGATATCCATCTTGC
GCCGGCGAAATTTACGTCGAGCTCTGCGGT|TCGCTATCACATACATGTCCTGGTTATATC
TGATTATGCAGAGGGACTAGCCACCGCTGT|GAGCTTAGCGACGGGACAGTTATTTACCGT
TAGAGCTCCGGACATCCGTGTCGCTATCAC|ATCACCCGTGTCGCTATCACATACATGTCC
CATACATGTCCTGGTTTGGATATCCATCTT|GCAAGGATAAGGTTGCGGACCTCTGATCCC
CATCGCGCCCCGGGACAAACCGGCTAAATA|ACACCCGTGTCGCTATCACATACATGTCCT
TTCCGCAATACGTGTATCCACTCTTGCGTA|AGGCCCAGGCGTTGCCCCCGTGTCGCTATC
CCTGCACGGAAATACCGATCAGCGGCAAAG|AGATGCCCAACAATAATTCCGCAATACGTG
TAGGATCCATGCTTGTCCGTGTCGCTATCA|CCCAATTCTTACTTCCGTGAACCTGAAATA
CCGGTATTGCAGGCAGTATCACGTGTCGGC|CGAGCTCTGCGGTAGGATCCATGCTTGTCC
ATCTCTTTTAGCTCGAAGCAAAAACCTACT|GGTAAGGAGTCGCGCTGGATTAGAGCTCCG
TCGCTATCACATACATGTCCTGGTTACAGG|ATACATGTCCTGGTTTCCGACATAAGGGTA
TAAACACTACGTCCGTGTCGCTATCACATA|CAACGCCTAGATCACATCTCTTTTAGCTCG
CTATCACATACATGTCCTGGTTTGGATATC|TCCACAGCAAGGATAAGGTTGCGGACCTCT
GACGGTCGAGCTTAGCGACGGGACAGTTAT|GTCGCTATCACATACATGTCCTGGTTGAGT
CCTTTAAACCAAGCGGACGCCCTGGCAATA|CTTTGCTCCATCGCGCCCCGGGACAAACCG
ACATGTCCTGGTTACAGGGTGTGATCTTGA|GTTTCCGACATAAGGGTAAGGACGGTCGAG
CTTTCCAGCGAACAGGCAAAATTCACTAAC|TGGCAAGCGTATCAGTTCCCCTTTAAACCA
CCGAGACATTAGGGCTTAGTCCCGCAAATA|ACATACATGTCCTGGTTGAATTAGAGAAGA
TTTAAAATAACACCGTGTCGCTATCACATA|TGTCCTGGTTTGGATATCCATCTTGCGAGT
GTGCACTGTGGACAGAGATACAGATGCCCA|CCGAGACATTAGGGCTTAGTCCCGCAAATA
ATGTCCTGGTTTCCGACATAAGGGTAAGGA|CGCTCTTCGGGGTAAACACTACGTCCGTGT
ACTTACGCCGTGTCGCTATCACATACATGT|TGTCGCTATCACATACATGTCCTGGTTTCC
ACTTCCGTGAACCTGAAATAATGTACGCTC|TCACTAACCGTGTCGCTATCACATACATGT
CTCGTTCAAGCACTCCAGTACTAGTTTACA|ACATGTCCTGGTTGAAGTACCGTGTCGCTA
TTAACCGTGTGGGCTCATTAATCTGGCAAG|ATCCGTGTCGCTATCACATACATGTCCTGG
TAATGTACGCTCTTCGGGGTAAACACTACG|TCACATACATGTCCTGGTTCAACGCCTAGA
TCTCGTTTGACTGGCTTTCCAGCGAACAGG|TGGGCTCATTAATCTGGCAAGCGTATCAGT
TTAAAATAACACCGTGTCGCTATCACATAC|GTCCTGGTTTGGATATCCATCTTGCGAGTG
ACATGTCCTGGTTGAATTAGAGAAGAATAT|TTGTGAGTTAACTATCAAGCCGTTCTACCG
ATCACATACATGTCCTGGTTGAGTCGCCCA|TTAGCTCGAAGCAAAAACCTACTTCCTTAA
GGTAAACACTACGTCCGTGTCGCTATCACA|TTCAACGCCTAGATCACATCTCTTTTAGCT
CCAACAATAATTCCGCAATACGTGTATCCA|ATATAGGCCCAGGCCCAGGCGTTGCCCCCG
CTATCACATACATGTCCTGGTTTAGCGAAC|TCTTGCGAGTGCACTGTGGACAGAGATACA
GTGTCGGCTACTTACGCCGTGTCGCTATCA|GCTTGTCCGTGTCGCTATCACATACATGTC
TCAACTCGTTCAAGCACTCCAGTACTAGTT|ACATACATGTCCTGGTTGAAGTACCGTGTC
CATACATGTCCTGGTTTTTTAAAATAACAC|TGTCGCTATCACATACATGTCCTGGTTTGG
AGGCCCAGGCGTTGCCCCCGTGTCGCTATC|TCTTACAGTGCGGCGAGCCGACGTCGCTAC
AGATGCCCAACAATAATTCCGCAATACGTG|CCGCAAATATAGGCCCAGGCCCAGGCGTTG
GGATCCATGCTTGTCCGTGTCGCTATCACA|CAATTCTTACTTCCGTGAACCTGAAATAAT
TCGCTATCACATACATGTCCTGGTTTACCC|ATACATGTCCTGGTTATACATGTCCTGGTT
CAGTACTAGTTTACACCGTGTCGCTATCAC|AGTACCGTGTCGCTATCACATACATGTCCT
ATGTCCTGGTTGAATTAGAGAAGAATATTG|GTGAGTTAACTATCAAGCCGTTCTACCGCG
ATACATGTCCTGGTTAAGATCCGGTATGAC|TCAGCGGCAAAGCATGAAGTTAGTGTGGCG
AACACTACGTCCGTGTCGCTATCACATACA|ACGCCTAGATCACATCTCTTTTAGCTCGAA
GCAAAAACCTACTTCCTTAACCGTGTGGGC|GATTAGAGCTCCGGACATCCGTGTCGCTAT
CCGGGACAAACCGGCTAAATAGGTCACGTG|TCGCTATCACATACATGTCCTGGTTTTTTA
TACGCTCTTCGGGGTAAACACTACGTCCGT|TACATGTCCTGGTTCAACGCCTAGATCACA
TCGCTATCACCCGTGTCGCTATCACATACA|ATACATGTCCTGGTTTAGCGAACCTGCACG
AAGAAGGTAAGGAGTCGCGCTGGATTAGAG|GCATGCCGTAACAGTCCGTGTCGCTATCAC
ATAGGTATGACCGTGTCGCTATCACATACA|GTTGATCGTTTTCCTAGGTCCACAGCAAGG
CTACTTACGCCGTGTCGCTATCACATACAT|CGTGTCGCTATCACATACATGTCCTGGTTT
AAATTCACTAACCGTGTCGCTATCACATAC|CCCTTTAAACCAAGCGGACGCCCTGGCAAT
CTGGCAATAACCCAAGATATTCTGGGAAGA|GACAAACCGGCTAAATAGGTCACGTGCGTG
AAAACCTACTTCCTTAACCGTGTGGGCTCA|TAGAGCTCCGGACATCCGTGTCGCTATCAC
TAGTGTGGCGGCGATAGGTATGACCGTGTC|CTTGCGTAAACAAGTTGATCGTTTTCCTAG
TGTCGCTATCACATACATGTCCTGGTTTAG|ATCCATCTTGCGAGTGCACTGTGGACAGAG
CCGTGTCGCTATCACATACATGTCCTGGTT|CCGACGTCGCTACCTTCCGTGTCGCTATCA
CTACTTCCTTAACCGTGTGGGCTCATTAAT|CTCCGGACATCCGTGTCGCTATCACATACA
GCCTAGATCACATCTCTTTTAGCTCGAAGC|GGGAAGAAGAAGGTAAGGAGTCGCGCTGGA
GTCATAGTTGCATTTCATCCGGTATTGCAG|CGCCGGCGAAATTTACGTCGAGCTCTGCGG
AACTCGTTCAAGCACTCCAGTACTAGTTTA|ATACATGTCCTGGTTGAAGTACCGTGTCGC
GGTGTGATCTTGATTATGCAGAGGGACTAG|AAGGACGGTCGAGCTTAGCGACGGGACAGT
ATTCCGCAATACGTGTATCCACTCTTGCGT|CAGGCCCAGGCGTTGCCCCCGTGTCGCTAT
CACATACATGTCCTGGTTGAATTAGAGAAG|CCTGGTTGTGAGTTAACTATCAAGCCGTTC
ACTCCAGTACTAGTTTACACCGTGTCGCTA|TTGAAGTACCGTGTCGCTATCACATACATG
ATTAATCTGGCAAGCGTATCAGTTCCCCTT|CATACATGTCCTGGTTTACCCTGGCACTTT
ACTTCCTTAACCGTGTGGGCTCATTAATCT|CCGGACATCCGTGTCGCTATCACATACATG
CCGCTGTCGCCGGCGAAATTTACGTCGAGC|TTACCGTGTCGCTATCACATACATGTCCTG
AAATTTACGTCGAGCTCTGCGGTAGGATCC|CACATACATGTCCTGGTTATATCCCAATTC
CGGACATCCGTGTCGCTATCACATACATGT|TGTCGCTATCACATACATGTCCTGGTTATA
TAGCTCGAAGCAAAAACCTACTTCCTTAAC|GTCGCGCTGGATTAGAGCTCCGGACATCCG
GCGCCCCGGGACAAACCGGCTAAATAGGTC|CCGTGTCGCTATCACATACATGTCCTGGTT
GGACGCCCTGGCAATAACCCAAGATATTCT|GCCCCGGGACAAACCGGCTAAATAGGTCAC
TATACATGTCCTGGTTAAGATCCGGTATGA|ATCAGCGGCAAAGCATGAAGTTAGTGTGGC
ATGTCCTGGTTTGGATATCCATCTTGCGAG|GATAAGGTTGCGGACCTCTGATCCCGCAGC
GAACAGGCAAAATTCACTAACCGTGTCGCT|TATCAGTTCCCCTTTAAACCAAGCGGACGC
AAGCGGACGCCCTGGCAATAACCCAAGATA|TCGCGCCCCGGGACAAACCGGCTAAATAGG
AAACCAAGCGGACGCCCTGGCAATAACCCA|CTCCATCGCGCCCCGGGACAAACCGGCTAA
CCATCGCGCCCCGGGACAAACCGGCTAAAT|GACACCCGTGTCGCTATCACATACATGTCC
TCCGGTATTGCAGGCAGTATCACGTGTCGG|TCGAGCTCTGCGGTAGGATCCATGCTTGTC
TGTACGCTCTTCGGGGTAAACACTACGTCC|CATACATGTCCTGGTTCAACGCCTAGATCA
TCGAGCTCTGCGGTAGGATCCATGCTTGTC|GTCCTGGTTATATCCCAATTCTTACTTCCG
GATAGGTATGACCGTGTCGCTATCACATAC|AGTTGATCGTTTTCCTAGGTCCACAGCAAG
GTCGCTATCACATACATGTCCTGGTTCAAC|CGTCGCTACCTTCCGTGTCGCTATCACATA
TCCCAATTCTTACTTCCGTGAACCTGAAAT|ACAGGCAAAATTCACTAACCGTGTCGCTAT
TACATGTCCTGGTTCAACTCGTTCAAGCAC|CCGTGTCGCTATCACATACATGTCCTGGTT
CTCTTCGGGGTAAACACTACGTCCGTGTCG|TGTCCTGGTTCAACGCCTAGATCACATCTC
AGTTCCCCTTTAAACCAAGCGGACGCCCTG|CTGGCACTTTGCTCCATCGCGCCCCGGGAC
ACATGTCCTGGTTTACCCTGGCACTTTGCT|GTTATACATGTCCTGGTTAAGATCCGGTAT
GCTATCACATACATGTCCTGGTTTCCGACA|TGAAATAATGTACGCTCTTCGGGGTAAACA
GCTATCACATACATGTCCTGGTTATACATG|GCGAACCTGCACGGAAATACCGATCAGCGG
TATTCTGGGAAGAAGAAGGTAAGGAGTCGC|GGTCACGTGCGTGCATGCCGTAACAGTCCG
GTTGCATTTCATCCGGTATTGCAGGCAGTA|CGAAATTTACGTCGAGCTCTGCGGTAGGAT
ATCACCCGTGTCGCTATCACATACATGTCC|TGTCCTGGTTTAGCGAACCTGCACGGAAAT
TTTTAGCTCGAAGCAAAAACCTACTTCCTT|GGAGTCGCGCTGGATTAGAGCTCCGGACAT
ACATGTCCTGGTTTAGCGAACCTGCACGGA|TGCACTGTGGACAGAGATACAGATGCCCAA
GGGACAAACCGGCTAAATAGGTCACGTGCG|GCTATCACATACATGTCCTGGTTTTTTAAA
GATATCCATCTTGCGAGTGCACTGTGGACA|ACCTCTGATCCCGCAGCCGAGACATTAGGG
CATAAGGGTAAGGACGGTCGAGCTTAGCGA|CACTACGTCCGTGTCGCTATCACATACATG
AACCGGCTAAATAGGTCACGTGCGTGCATG|ACATACATGTCCTGGTTTTTTAAAATAACA
GCAGAGGGACTAGCCACCGCTGTCGCCGGC|GCGACGGGACAGTTATTTACCGTGTCGCTA
GGTTTAGCGAACCTGCACGGAAATACCGAT|GACAGAGATACAGATGCCCAACAATAATTC
ACAAACCGGCTAAATAGGTCACGTGCGTGC|ATCACATACATGTCCTGGTTTTTTAAAATA
GCGGCAAAGCATGAAGTTAGTGTGGCGGCG|CAATACGTGTATCCACTCTTGCGTAAACAA
CTCCGGACATCCGTGTCGCTATCACATACA|CCGTGTCGCTATCACATACATGTCCTGGTT
AGCAAAAACCTACTTCCTTAACCGTGTGGG|GGATTAGAGCTCCGGACATCCGTGTCGCTA
TACTTCCTTAACCGTGTGGGCTCATTAATC|TCCGGACATCCGTGTCGCTATCACATACAT
GTCCTGGTTTCCGACATAAGGGTAAGGACG|CTCTTCGGGGTAAACACTACGTCCGTGTCG
CATGTCCTGGTTATATCCCAATTCTTACTT|CTGGCTTTCCAGCGAACAGGCAAAATTCAC
ATCACATACATGTCCTGGTTTTTTAAAATA|ACCGTGTCGCTATCACATACATGTCCTGGT
CCACAGCAAGGATAAGGTTGCGGACCTCTG|TTCAAGCACTCCAGTACTAGTTTACACCGT
CACATACATGTCCTGGTTATACATGTCCTG|CCTGCACGGAAATACCGATCAGCGGCAAAG
CTTCCTTAACCGTGTGGGCTCATTAATCTG|CGGACATCCGTGTCGCTATCACATACATGT
AACGCCTAGATCACATCTCTTTTAGCTCGA|TCTGGGAAGAAGAAGGTAAGGAGTCGCGCT
ACCGCTGTCGCCGGCGAAATTTACGTCGAG|TTTACCGTGTCGCTATCACATACATGTCCT
TCCGTGTCGCTATCACATACATGTCCTGGT|TCACATCTCTTTTAGCTCGAAGCAAAAACC
CTGGTTTAGCGAACCTGCACGGAAATACCG|TGGACAGAGATACAGATGCCCAACAATAAT
CATACATGTCCTGGTTCAACGCCTAGATCA|GCAATAACCCAAGATATTCTGGGAAGAAGA
AACCAAGCGGACGCCCTGGCAATAACCCAA|TCCATCGCGCCCCGGGACAAACCGGCTAAA
ATCACATCTCTTTTAGCTCGAAGCAAAAAC|AAGAAGGTAAGGAGTCGCGCTGGATTAGAG
GGTAGGATCCATGCTTGTCCGTGTCGCTAT|ATCCCAATTCTTACTTCCGTGAACCTGAAA
TCAACGCCTAGATCACATCTCTTTTAGCTC|ATTCTGGGAAGAAGAAGGTAAGGAGTCGCG
TCCGCAATACGTGTATCCACTCTTGCGTAA|GGCCCAGGCGTTGCCCCCGTGTCGCTATCA
TACACCGTGTCGCTATCACATACATGTCCT|GCTATCACATACATGTCCTGGTTGTGAGTT
TTGCATTTCATCCGGTATTGCAGGCAGTAT|GAAATTTACGTCGAGCTCTGCGGTAGGATC
ACAATAATTCCGCAATACGTGTATCCACTC|TAGGCCCAGGCCCAGGCGTTGCCCCCGTGT
ATGACACCCGTGTCGCTATCACATACATGT|TGGCGGCGATAGGTATGACCGTGTCGCTAT
TTCAAGCACTCCAGTACTAGTTTACACCGT|GTCCTGGTTGAAGTACCGTGTCGCTATCAC
CGTGTCGCTATCACATACATGTCCTGGTTC|CGACGTCGCTACCTTCCGTGTCGCTATCAC
GATCCATGCTTGTCCGTGTCGCTATCACAT|AATTCTTACTTCCGTGAACCTGAAATAATG
TCCTGGTTTAGCGAACCTGCACGGAAATAC|TGTGGACAGAGATACAGATGCCCAACAATA
TTTACCCTGGCACTTTGCTCCATCGCGCCC|CCTGGTTAAGATCCGGTATGACACCCGTGT
TCTGCGGTAGGATCCATGCTTGTCCGTGTC|GTTATATCCCAATTCTTACTTCCGTGAACC
ATTCACTAACCGTGTCGCTATCACATACAT|CTTTAAACCAAGCGGACGCCCTGGCAATAA
TATCCACTCTTGCGTAAACAAGTTGATCGT|CCCCCGTGTCGCTATCACATACATGTCCTG
TATCACATACATGTCCTGGTTCAACTCGTT|CTACCTTCCGTGTCGCTATCACATACATGT
GCAGTATCACGTGTCGGCTACTTACGCCGT|TAGGATCCATGCTTGTCCGTGTCGCTATCA
TGTCGCTATCACATACATGTCCTGGTTATA|TTTAGCGAACCTGCACGGAAATACCGATCA
CACTACGTCCGTGTCGCTATCACATACATG|GCCTAGATCACATCTCTTTTAGCTCGAAGC
GGATATCCATCTTGCGAGTGCACTGTGGAC|GACCTCTGATCCCGCAGCCGAGACATTAGG
CTGGTTAAGATCCGGTATGACACCCGTGTC|AAGCATGAAGTTAGTGTGGCGGCGATAGGT
CCGTGTCGCTATCACATACATGTCCTGGTT|GTGAACCTGAAATAATGTACGCTCTTCGGG
CGCAATACGTGTATCCACTCTTGCGTAAAC|CCCAGGCGTTGCCCCCGTGTCGCTATCACA
GGTTTGGATATCCATCTTGCGAGTGCACTG|TTGCGGACCTCTGATCCCGCAGCCGAGACA
CCGTAACAGTCCGTGTCGCTATCACCCGTG|CCGTGTCGCTATCACATACATGTCCTGGTT
CATACATGTCCTGGTTTCCGACATAAGGGT|ATGTACGCTCTTCGGGGTAAACACTACGTC
CTATCACATACATGTCCTGGTTACAGGGTG|CATGTCCTGGTTTCCGACATAAGGGTAAGG
TCACATACATGTCCTGGTTACAGGGTGTGA|GTCCTGGTTTCCGACATAAGGGTAAGGACG
CATGCTTGTCCGTGTCGCTATCACATACAT|CTTACTTCCGTGAACCTGAAATAATGTACG
TTCCTAGGTCCACAGCAAGGATAAGGTTGC|TTCAACTCGTTCAAGCACTCCAGTACTAGT
GCTATCACATACATGTCCTGGTTGAATTAG|CATGTCCTGGTTGTGAGTTAACTATCAAGC
TGTGGCGGCGATAGGTATGACCGTGTCGCT|GCGTAAACAAGTTGATCGTTTTCCTAGGTC
CCGTGTCGCTATCACATACATGTCCTGGTT|TCACATACATGTCCTGGTTGTGAGTTAACT
GGCCCAGGCCCAGGCGTTGCCCCCGTGTCG|ATTGTTCTTACAGTGCGGCGAGCCGACGTC
TCCTGGTTATATCCCAATTCTTACTTCCGT|CTTTCCAGCGAACAGGCAAAATTCACTAAC
TATCCCAATTCTTACTTCCGTGAACCTGAA|GAACAGGCAAAATTCACTAACCGTGTCGCT
TCACGTGCGTGCATGCCGTAACAGTCCGTG|TTTTTTAAAATAACACCGTGTCGCTATCAC
CCGTGTCGCTATCACATACATGTCCTGGTT|ATCACATACATGTCCTGGTTTCCGACATAA
ACTTTGCTCCATCGCGCCCCGGGACAAACC|TCCGGTATGACACCCGTGTCGCTATCACAT
GCTCCGGACATCCGTGTCGCTATCACATAC|CCCGTGTCGCTATCACATACATGTCCTGGT
CCTGGCACTTTGCTCCATCGCGCCCCGGGA|TTAAGATCCGGTATGACACCCGTGTCGCTA
TGAAATAATGTACGCTCTTCGGGGTAAACA|CGCTATCACATACATGTCCTGGTTCAACGC
CGTGTCGCTATCACATACATGTCCTGGTTA|TCACATACATGTCCTGGTTTCCGACATAAG
GCTACTTACGCCGTGTCGCTATCACATACA|CCGTGTCGCTATCACATACATGTCCTGGTT
GTCGAGCTCTGCGGTAGGATCCATGCTTGT|TGTCCTGGTTATATCCCAATTCTTACTTCC
TGGTTTACCCTGGCACTTTGCTCCATCGCG|TGTCCTGGTTAAGATCCGGTATGACACCCG
TACATGTCCTGGTTATACATGTCCTGGTTA|CACGGAAATACCGATCAGCGGCAAAGCATG
TCAGCGGCAAAGCATGAAGTTAGTGTGGCG|CCGCAATACGTGTATCCACTCTTGCGTAAA
GCACTTTGCTCCATCGCGCCCCGGGACAAA|GATCCGGTATGACACCCGTGTCGCTATCAC
CTTGCGTAAACAAGTTGATCGTTTTCCTAG|TCGCTATCACATACATGTCCTGGTTCAACT
TCACATACATGTCCTGGTTATACATGTCCT|ACCTGCACGGAAATACCGATCAGCGGCAAA
TCACATACATGTCCTGGTTTTTTAAAATAA|CCGTGTCGCTATCACATACATGTCCTGGTT
ATACATGTCCTGGTTATACATGTCCTGGTT|GCACGGAAATACCGATCAGCGGCAAAGCAT
CATACATGTCCTGGTTGAGTCGCCCACCTG|CTCGAAGCAAAAACCTACTTCCTTAACCGT
ATTATGCAGAGGGACTAGCCACCGCTGTCG|GCTTAGCGACGGGACAGTTATTTACCGTGT
CACTAACCGTGTCGCTATCACATACATGTC|TAAACCAAGCGGACGCCCTGGCAATAACCC
CTTACGCCGTGTCGCTATCACATACATGTC|GTCGCTATCACATACATGTCCTGGTTTCCG
AGCGGCAAAGCATGAAGTTAGTGTGGCGGC|GCAATACGTGTATCCACTCTTGCGTAAACA
TTGCCCCCGTGTCGCTATCACATACATGTC|GGCGAGCCGACGTCGCTACCTTCCGTGTCG
GTGCATGCCGTAACAGTCCGTGTCGCTATC|AATAACACCGTGTCGCTATCACATACATGT
CGTGTCGCTATCACATACATGTCCTGGTTT|TGAACCTGAAATAATGTACGCTCTTCGGGG
GGGTAAACACTACGTCCGTGTCGCTATCAC|GTTCAACGCCTAGATCACATCTCTTTTAGC
AATACGTGTATCCACTCTTGCGTAAACAAG|AGGCGTTGCCCCCGTGTCGCTATCACATAC
CAAGCACTCCAGTACTAGTTTACACCGTGT|CCTGGTTGAAGTACCGTGTCGCTATCACAT
TTAGAGCTCCGGACATCCGTGTCGCTATCA|TATCACCCGTGTCGCTATCACATACATGTC
TTGAGTCGCCCACCTGATCTCGTTTGACTG|CTACTTCCTTAACCGTGTGGGCTCATTAAT
AGCGAACCTGCACGGAAATACCGATCAGCG|AGATACAGATGCCCAACAATAATTCCGCAA
ATCTGGCAAGCGTATCAGTTCCCCTTTAAA|CATGTCCTGGTTTACCCTGGCACTTTGCTC
TGTCGCTATCACATACATGTCCTGGTTTGG|CTAGGTCCACAGCAAGGATAAGGTTGCGGA
GAGTGCACTGTGGACAGAGATACAGATGCC|AGCCGAGACATTAGGGCTTAGTCCCGCAAA
GCGGACGCCCTGGCAATAACCCAAGATATT|GCGCCCCGGGACAAACCGGCTAAATAGGTC
GTTGAGTCGCCCACCTGATCTCGTTTGACT|CCTACTTCCTTAACCGTGTGGGCTCATTAA
CCACCTGATCTCGTTTGACTGGCTTTCCAG|TAACCGTGTGGGCTCATTAATCTGGCAAGC
TCACATACATGTCCTGGTTTACCCTGGCAC|GTCCTGGTTATACATGTCCTGGTTAAGATC
TAGTTTACACCGTGTCGCTATCACATACAT|GTGTCGCTATCACATACATGTCCTGGTTGT
CGCTATCACCCGTGTCGCTATCACATACAT|TACATGTCCTGGTTTAGCGAACCTGCACGG
GATGCCCAACAATAATTCCGCAATACGTGT|CGCAAATATAGGCCCAGGCCCAGGCGTTGC
AGGGACTAGCCACCGCTGTCGCCGGCGAAA|CGGGACAGTTATTTACCGTGTCGCTATCAC
CACATACATGTCCTGGTTACAGGGTGTGAT|TCCTGGTTTCCGACATAAGGGTAAGGACGG
AGGTCCACAGCAAGGATAAGGTTGCGGACC|CTCGTTCAAGCACTCCAGTACTAGTTTACA
CGTTTGACTGGCTTTCCAGCGAACAGGCAA|GCTCATTAATCTGGCAAGCGTATCAGTTCC
GCAAGCGTATCAGTTCCCCTTTAAACCAAG|CCTGGTTTACCCTGGCACTTTGCTCCATCG
ATCTTGCGAGTGCACTGTGGACAGAGATAC|ATCCCGCAGCCGAGACATTAGGGCTTAGTC
GCGAGTGCACTGTGGACAGAGATACAGATG|GCAGCCGAGACATTAGGGCTTAGTCCCGCA
TGCCGTAACAGTCCGTGTCGCTATCACCCG|CACCGTGTCGCTATCACATACATGTCCTGG
GACCGTGTCGCTATCACATACATGTCCTGG|TTTTCCTAGGTCCACAGCAAGGATAAGGTT
GGTTATACATGTCCTGGTTAAGATCCGGTA|CCGATCAGCGGCAAAGCATGAAGTTAGTGT
TCACGTGTCGGCTACTTACGCCGTGTCGCT|CCATGCTTGTCCGTGTCGCTATCACATACA
TATTGCAGGCAGTATCACGTGTCGGCTACT|CTCTGCGGTAGGATCCATGCTTGTCCGTGT
TCCCGCAAATATAGGCCCAGGCCCAGGCGT|ATTAGAGAAGAATATTGTTCTTACAGTGCG
TCACATACATGTCCTGGTTGAATTAGAGAA|TCCTGGTTGTGAGTTAACTATCAAGCCGTT
AGATATTCTGGGAAGAAGAAGGTAAGGAGT|ATAGGTCACGTGCGTGCATGCCGTAACAGT
CTGGCAAGCGTATCAGTTCCCCTTTAAACC|TGTCCTGGTTTACCCTGGCACTTTGCTCCA
ACAGCAAGGATAAGGTTGCGGACCTCTGAT|CAAGCACTCCAGTACTAGTTTACACCGTGT
CACATACATGTCCTGGTTTGGATATCCATC|CAGCAAGGATAAGGTTGCGGACCTCTGATC
ACCTGATCTCGTTTGACTGGCTTTCCAGCG|ACCGTGTGGGCTCATTAATCTGGCAAGCGT
TCTCTTTTAGCTCGAAGCAAAAACCTACTT|GTAAGGAGTCGCGCTGGATTAGAGCTCCGG
CGCTATCACATACATGTCCTGGTTTACCCT|TACATGTCCTGGTTATACATGTCCTGGTTA
TTAGCGACGGGACAGTTATTTACCGTGTCG|ATACATGTCCTGGTTGAGTCGCCCACCTGA
ACATGTCCTGGTTGAGTCGCCCACCTGATC|GAAGCAAAAACCTACTTCCTTAACCGTGTG
ATAATGTACGCTCTTCGGGGTAAACACTAC|ATCACATACATGTCCTGGTTCAACGCCTAG
ACCGATCAGCGGCAAAGCATGAAGTTAGTG|TAATTCCGCAATACGTGTATCCACTCTTGC
CGCAAATATAGGCCCAGGCCCAGGCGTTGC|AGAGAAGAATATTGTTCTTACAGTGCGGCG
AATAATGTACGCTCTTCGGGGTAAACACTA|TATCACATACATGTCCTGGTTCAACGCCTA
TGTCCTGGTTTTTTAAAATAACACCGTGTC|TATCACATACATGTCCTGGTTTGGATATCC
TTTTCCTAGGTCCACAGCAAGGATAAGGTT|GGTTCAACTCGTTCAAGCACTCCAGTACTA
CATACATGTCCTGGTTCAACTCGTTCAAGC|TTCCGTGTCGCTATCACATACATGTCCTGG
ATGTACGCTCTTCGGGGTAAACACTACGTC|ACATACATGTCCTGGTTCAACGCCTAGATC
GGTCGAGCTTAGCGACGGGACAGTTATTTA|GCTATCACATACATGTCCTGGTTGAGTCGC
GTATCCACTCTTGCGTAAACAAGTTGATCG|GCCCCCGTGTCGCTATCACATACATGTCCT
CAGCCGAGACATTAGGGCTTAGTCCCGCAA|ATCACATACATGTCCTGGTTGAATTAGAGA
GCCCAACAATAATTCCGCAATACGTGTATC|AAATATAGGCCCAGGCCCAGGCGTTGCCCC
AGTCCCGCAAATATAGGCCCAGGCCCAGGC|GAATTAGAGAAGAATATTGTTCTTACAGTG
GTGGACAGAGATACAGATGCCCAACAATAA|ATTAGGGCTTAGTCCCGCAAATATAGGCCC
AGTATCACGTGTCGGCTACTTACGCCGTGT|GGATCCATGCTTGTCCGTGTCGCTATCACA
CATGTCCTGGTTACAGGGTGTGATCTTGAT|TTTCCGACATAAGGGTAAGGACGGTCGAGC
CACATACATGTCCTGGTTTTTTAAAATAAC|CGTGTCGCTATCACATACATGTCCTGGTTT
TCCTGGTTTTTTAAAATAACACCGTGTCGC|TCACATACATGTCCTGGTTTGGATATCCAT
GTGGCGGCGATAGGTATGACCGTGTCGCTA|CGTAAACAAGTTGATCGTTTTCCTAGGTCC
ATGTCCTGGTTTAGCGAACCTGCACGGAAA|CACTGTGGACAGAGATACAGATGCCCAACA
GTAGGATCCATGCTTGTCCGTGTCGCTATC|TCCCAATTCTTACTTCCGTGAACCTGAAAT
TCCTGGTTTGGATATCCATCTTGCGAGTGC|AAGGTTGCGGACCTCTGATCCCGCAGCCGA
TAATTCCGCAATACGTGTATCCACTCTTGC|CCCAGGCCCAGGCGTTGCCCCCGTGTCGCT
GCTATCACATACATGTCCTGGTTTTTTAAA|ATGACCGTGTCGCTATCACATACATGTCCT
ATAGGCCCAGGCCCAGGCGTTGCCCCCGTG|AATATTGTTCTTACAGTGCGGCGAGCCGAC
ATACATGTCCTGGTTTGGATATCCATCTTG|CAAGGATAAGGTTGCGGACCTCTGATCCCG
ACAGTTATTTACCGTGTCGCTATCACATAC|GGTTGAGTCGCCCACCTGATCTCGTTTGAC
ATCACATACATGTCCTGGTTATATCCCAAT|TCGTTTGACTGGCTTTCCAGCGAACAGGCA
ACGCTCTTCGGGGTAAACACTACGTCCGTG|ACATGTCCTGGTTCAACGCCTAGATCACAT
TACTTACGCCGTGTCGCTATCACATACATG|GTGTCGCTATCACATACATGTCCTGGTTTC
CCAAGCGGACGCCCTGGCAATAACCCAAGA|CATCGCGCCCCGGGACAAACCGGCTAAATA
GTCGCGCTGGATTAGAGCTCCGGACATCCG|GTCCGTGTCGCTATCACCCGTGTCGCTATC
CACAGCAAGGATAAGGTTGCGGACCTCTGA|TCAAGCACTCCAGTACTAGTTTACACCGTG
GGCACTTTGCTCCATCGCGCCCCGGGACAA|AGATCCGGTATGACACCCGTGTCGCTATCA
TGATCTTGATTATGCAGAGGGACTAGCCAC|ACGGTCGAGCTTAGCGACGGGACAGTTATT
TCACATACATGTCCTGGTTCAACTCGTTCA|ACCTTCCGTGTCGCTATCACATACATGTCC
CGCTATCACATACATGTCCTGGTTTTTTAA|TATGACCGTGTCGCTATCACATACATGTCC
ATCTCGTTTGACTGGCTTTCCAGCGAACAG|GTGGGCTCATTAATCTGGCAAGCGTATCAG
GTGTCGCTATCACATACATGTCCTGGTTTA|CACATACATGTCCTGGTTATACATGTCCTG
AACCGTGTCGCTATCACATACATGTCCTGG|CCAAGCGGACGCCCTGGCAATAACCCAAGA
CATTTCATCCGGTATTGCAGGCAGTATCAC|ATTTACGTCGAGCTCTGCGGTAGGATCCAT
CCGATCAGCGGCAAAGCATGAAGTTAGTGT|AATTCCGCAATACGTGTATCCACTCTTGCG
TGTCGCTATCACATACATGTCCTGGTTATA|CCTGATCTCGTTTGACTGGCTTTCCAGCGA
TACATGTCCTGGTTTGGATATCCATCTTGC|AAGGATAAGGTTGCGGACCTCTGATCCCGC
TGGCTTTCCAGCGAACAGGCAAAATTCACT|ATCTGGCAAGCGTATCAGTTCCCCTTTAAA
TCGCTATCACATACATGTCCTGGTTTTTTA|GTATGACCGTGTCGCTATCACATACATGTC
GTCCGTGTCGCTATCACCCGTGTCGCTATC|CTATCACATACATGTCCTGGTTTAGCGAAC
GGCAAAGCATGAAGTTAGTGTGGCGGCGAT|ATACGTGTATCCACTCTTGCGTAAACAAGT
CATGTCCTGGTTTGGATATCCATCTTGCGA|GGATAAGGTTGCGGACCTCTGATCCCGCAG
CTTTTAGCTCGAAGCAAAAACCTACTTCCT|AGGAGTCGCGCTGGATTAGAGCTCCGGACA
TGTCGCTATCACATACATGTCCTGGTTTTT|AGGTATGACCGTGTCGCTATCACATACATG
ATAATTCCGCAATACGTGTATCCACTCTTG|GCCCAGGCCCAGGCGTTGCCCCCGTGTCGC
ACACCCGTGTCGCTATCACATACATGTCCT|CGGCGATAGGTATGACCGTGTCGCTATCAC
TTCCGACATAAGGGTAAGGACGGTCGAGCT|GGTAAACACTACGTCCGTGTCGCTATCACA
CATGTCCTGGTTTAGCGAACCTGCACGGAA|GCACTGTGGACAGAGATACAGATGCCCAAC
AGTTGCATTTCATCCGGTATTGCAGGCAGT|GCGAAATTTACGTCGAGCTCTGCGGTAGGA
CCGTGTCGCTATCACATACATGTCCTGGTT|TGGTTTAGCGAACCTGCACGGAAATACCGA
CGCCCCGGGACAAACCGGCTAAATAGGTCA|CGTGTCGCTATCACATACATGTCCTGGTTT
ATACATGTCCTGGTTACAGGGTGTGATCTT|TGGTTTCCGACATAAGGGTAAGGACGGTCG
CGCGCCCCGGGACAAACCGGCTAAATAGGT|CCCGTGTCGCTATCACATACATGTCCTGGT
TGAACCTGAAATAATGTACGCTCTTCGGGG|CCGTGTCGCTATCACATACATGTCCTGGTT
GTCCGTGTCGCTATCACATACATGTCCTGG|ATCACATCTCTTTTAGCTCGAAGCAAAAAC
CTGATCTCGTTTGACTGGCTTTCCAGCGAA|CGTGTGGGCTCATTAATCTGGCAAGCGTAT
TCTTGATTATGCAGAGGGACTAGCCACCGC|GTCGAGCTTAGCGACGGGACAGTTATTTAC
TCCGTGTCGCTATCACCCGTGTCGCTATCA|TATCACATACATGTCCTGGTTTAGCGAACC
AGTCCGTGTCGCTATCACCCGTGTCGCTAT|GCTATCACATACATGTCCTGGTTTAGCGAA
TTACCCTGGCACTTTGCTCCATCGCGCCCC|CTGGTTAAGATCCGGTATGACACCCGTGTC
TGGTTTTTTAAAATAACACCGTGTCGCTAT|CATACATGTCCTGGTTTGGATATCCATCTT
GTACGCTCTTCGGGGTAAACACTACGTCCG|ATACATGTCCTGGTTCAACGCCTAGATCAC
GCATTTCATCCGGTATTGCAGGCAGTATCA|AATTTACGTCGAGCTCTGCGGTAGGATCCA
TTGCGTAAACAAGTTGATCGTTTTCCTAGG|CGCTATCACATACATGTCCTGGTTCAACTC
CATACATGTCCTGGTTTACCCTGGCACTTT|CTGGTTATACATGTCCTGGTTAAGATCCGG
CTTGTCCGTGTCGCTATCACATACATGTCC|CTTCCGTGAACCTGAAATAATGTACGCTCT
CCGTGAACCTGAAATAATGTACGCTCTTCG|TAACCGTGTCGCTATCACATACATGTCCTG
CACCGTGTCGCTATCACATACATGTCCTGG|TATCACATACATGTCCTGGTTGTGAGTTAA
CCTGGTTTTTTAAAATAACACCGTGTCGCT|CACATACATGTCCTGGTTTGGATATCCATC
GACATAAGGGTAAGGACGGTCGAGCTTAGC|AACACTACGTCCGTGTCGCTATCACATACA
ACATCCGTGTCGCTATCACATACATGTCCT|CGCTATCACATACATGTCCTGGTTATACAT
GTATCACGTGTCGGCTACTTACGCCGTGTC|GATCCATGCTTGTCCGTGTCGCTATCACAT
CTAGGTCCACAGCAAGGATAAGGTTGCGGA|AACTCGTTCAAGCACTCCAGTACTAGTTTA
TCGAAGCAAAAACCTACTTCCTTAACCGTG|CGCTGGATTAGAGCTCCGGACATCCGTGTC
ATGTCCTGGTTGAGTCGCCCACCTGATCTC|AGCAAAAACCTACTTCCTTAACCGTGTGGG
ATACATGTCCTGGTTTAGCGAACCTGCACG|AGTGCACTGTGGACAGAGATACAGATGCCC
CGCTATCACATACATGTCCTGGTTCAACTC|TCGCTACCTTCCGTGTCGCTATCACATACA
CCTGGTTTAGCGAACCTGCACGGAAATACC|GTGGACAGAGATACAGATGCCCAACAATAA
AGGGCTTAGTCCCGCAAATATAGGCCCAGG|CCTGGTTGAATTAGAGAAGAATATTGTTCT
CTAGTTTACACCGTGTCGCTATCACATACA|CGTGTCGCTATCACATACATGTCCTGGTTG
AGCTCTGCGGTAGGATCCATGCTTGTCCGT|CTGGTTATATCCCAATTCTTACTTCCGTGA
CTATCACATACATGTCCTGGTTTCCGACAT|GAAATAATGTACGCTCTTCGGGGTAAACAC
TGGTTATATCCCAATTCTTACTTCCGTGAA|TCCAGCGAACAGGCAAAATTCACTAACCGT
GGTTGCGGACCTCTGATCCCGCAGCCGAGA|ACTAGTTTACACCGTGTCGCTATCACATAC
GTGTCGCTATCACCCGTGTCGCTATCACAT|CACATACATGTCCTGGTTTAGCGAACCTGC
TTACGTCGAGCTCTGCGGTAGGATCCATGC|TACATGTCCTGGTTATATCCCAATTCTTAC
TCCTGGTTAAGATCCGGTATGACACCCGTG|CAAAGCATGAAGTTAGTGTGGCGGCGATAG
AAGTTAGTGTGGCGGCGATAGGTATGACCG|CACTCTTGCGTAAACAAGTTGATCGTTTTC
GTGCGTGCATGCCGTAACAGTCCGTGTCGC|TTAAAATAACACCGTGTCGCTATCACATAC
GACGCCCTGGCAATAACCCAAGATATTCTG|CCCCGGGACAAACCGGCTAAATAGGTCACG
CCTGGTTGAATTAGAGAAGAATATTGTTCT|GTTAACTATCAAGCCGTTCTACCGCGCCCT
GCAAATATAGGCCCAGGCCCAGGCGTTGCC|GAGAAGAATATTGTTCTTACAGTGCGGCGA
CTTAACCGTGTGGGCTCATTAATCTGGCAA|CATCCGTGTCGCTATCACATACATGTCCTG
CATGTCCTGGTTCAACGCCTAGATCACATC|TAACCCAAGATATTCTGGGAAGAAGAAGGT
TGTCCTGGTTATATCCCAATTCTTACTTCC|GGCTTTCCAGCGAACAGGCAAAATTCACTA
GTCGCTATCACATACATGTCCTGGTTTTTT|GGTATGACCGTGTCGCTATCACATACATGT
GAGATACAGATGCCCAACAATAATTCCGCA|CTTAGTCCCGCAAATATAGGCCCAGGCCCA
CTAACCGTGTCGCTATCACATACATGTCCT|AACCAAGCGGACGCCCTGGCAATAACCCAA
TATTTACCGTGTCGCTATCACATACATGTC|AGTCGCCCACCTGATCTCGTTTGACTGGCT
TCCGTGTCGCTATCACATACATGTCCTGGT|CGTGAACCTGAAATAATGTACGCTCTTCGG
TACATGTCCTGGTTAAGATCCGGTATGACA|CAGCGGCAAAGCATGAAGTTAGTGTGGCGG
ATCACGTGTCGGCTACTTACGCCGTGTCGC|TCCATGCTTGTCCGTGTCGCTATCACATAC
TATCAGTTCCCCTTTAAACCAAGCGGACGC|TACCCTGGCACTTTGCTCCATCGCGCCCCG
GCTTAGCGACGGGACAGTTATTTACCGTGT|ACATACATGTCCTGGTTGAGTCGCCCACCT
AAGGAGTCGCGCTGGATTAGAGCTCCGGAC|TAACAGTCCGTGTCGCTATCACCCGTGTCG
TCCTGGTTATACATGTCCTGGTTAAGATCC|AATACCGATCAGCGGCAAAGCATGAAGTTA
GTATGACACCCGTGTCGCTATCACATACAT|TGTGGCGGCGATAGGTATGACCGTGTCGCT
GGCTAAATAGGTCACGTGCGTGCATGCCGT|ACATGTCCTGGTTTTTTAAAATAACACCGT
GTGTCGCTATCACATACATGTCCTGGTTAT|ACCTGATCTCGTTTGACTGGCTTTCCAGCG
TGCCCAACAATAATTCCGCAATACGTGTAT|CAAATATAGGCCCAGGCCCAGGCGTTGCCC
TCCACAGCAAGGATAAGGTTGCGGACCTCT|GTTCAAGCACTCCAGTACTAGTTTACACCG
GTCGCCCACCTGATCTCGTTTGACTGGCTT|TTCCTTAACCGTGTGGGCTCATTAATCTGG
ACATAAGGGTAAGGACGGTCGAGCTTAGCG|ACACTACGTCCGTGTCGCTATCACATACAT
ATCACATACATGTCCTGGTTCAACTCGTTC|TACCTTCCGTGTCGCTATCACATACATGTC
CAAAGCATGAAGTTAGTGTGGCGGCGATAG|ACGTGTATCCACTCTTGCGTAAACAAGTTG
TAGCGACGGGACAGTTATTTACCGTGTCGC|TACATGTCCTGGTTGAGTCGCCCACCTGAT
TACTTCCGTGAACCTGAAATAATGTACGCT|TTCACTAACCGTGTCGCTATCACATACATG
TCCAGCGAACAGGCAAAATTCACTAACCGT|CAAGCGTATCAGTTCCCCTTTAAACCAAGC
ACGGAAATACCGATCAGCGGCAAAGCATGA|CCCAACAATAATTCCGCAATACGTGTATCC
TTTCATCCGGTATTGCAGGCAGTATCACGT|TTACGTCGAGCTCTGCGGTAGGATCCATGC
GCCCACCTGATCTCGTTTGACTGGCTTTCC|CTTAACCGTGTGGGCTCATTAATCTGGCAA
GGTAAGGAGTCGCGCTGGATTAGAGCTCCG|CCGTAACAGTCCGTGTCGCTATCACCCGTG
CAAAATTCACTAACCGTGTCGCTATCACAT|TCCCCTTTAAACCAAGCGGACGCCCTGGCA
GCTGTCGCCGGCGAAATTTACGTCGAGCTC|ACCGTGTCGCTATCACATACATGTCCTGGT
ATCCGGTATGACACCCGTGTCGCTATCACA|GTTAGTGTGGCGGCGATAGGTATGACCGTG
GTCACGTGCGTGCATGCCGTAACAGTCCGT|GTTTTTTAAAATAACACCGTGTCGCTATCA
TGTCCTGGTTCAACTCGTTCAAGCACTCCA|GTCGCTATCACATACATGTCCTGGTTGAAG
TCATAGTTGCATTTCATCCGGTATTGCAGG|GCCGGCGAAATTTACGTCGAGCTCTGCGGT
CTGGTTCAACGCCTAGATCACATCTCTTTT|AAGATATTCTGGGAAGAAGAAGGTAAGGAG
TACGCCGTGTCGCTATCACATACATGTCCT|CGCTATCACATACATGTCCTGGTTTCCGAC
GCAAGGATAAGGTTGCGGACCTCTGATCCC|GCACTCCAGTACTAGTTTACACCGTGTCGC
ATCCCGCAGCCGAGACATTAGGGCTTAGTC|GTCGCTATCACATACATGTCCTGGTTGAAT
ACATGTCCTGGTTAAGATCCGGTATGACAC|AGCGGCAAAGCATGAAGTTAGTGTGGCGGC
CCCGTGTCGCTATCACATACATGTCCTGGT|GCCGACGTCGCTACCTTCCGTGTCGCTATC
GAGCTTAGCGACGGGACAGTTATTTACCGT|TCACATACATGTCCTGGTTGAGTCGCCCAC
TGGTTTAGCGAACCTGCACGGAAATACCGA|GGACAGAGATACAGATGCCCAACAATAATT
GTCGCTATCACATACATGTCCTGGTTATAT|CTGATCTCGTTTGACTGGCTTTCCAGCGAA
ATATCCATCTTGCGAGTGCACTGTGGACAG|CCTCTGATCCCGCAGCCGAGACATTAGGGC
TTGCGAGTGCACTGTGGACAGAGATACAGA|CCGCAGCCGAGACATTAGGGCTTAGTCCCG
ACTGTGGACAGAGATACAGATGCCCAACAA|GACATTAGGGCTTAGTCCCGCAAATATAGG
CCTGGTTCAACGCCTAGATCACATCTCTTT|CAAGATATTCTGGGAAGAAGAAGGTAAGGA
CGTCCGTGTCGCTATCACATACATGTCCTG|GATCACATCTCTTTTAGCTCGAAGCAAAAA
CCAAGATATTCTGGGAAGAAGAAGGTAAGG|TAAATAGGTCACGTGCGTGCATGCCGTAAC
GATAAGGTTGCGGACCTCTGATCCCGCAGC|CCAGTACTAGTTTACACCGTGTCGCTATCA
CCCCGGGACAAACCGGCTAAATAGGTCACG|TGTCGCTATCACATACATGTCCTGGTTTTT
ATACATGTCCTGGTTATATCCCAATTCTTA|TGACTGGCTTTCCAGCGAACAGGCAAAATT
AGAAGAAGGTAAGGAGTCGCGCTGGATTAG|GTGCATGCCGTAACAGTCCGTGTCGCTATC
TGCACGGAAATACCGATCAGCGGCAAAGCA|ATGCCCAACAATAATTCCGCAATACGTGTA
CACTTTGCTCCATCGCGCCCCGGGACAAAC|ATCCGGTATGACACCCGTGTCGCTATCACA
TACATGTCCTGGTTTACCCTGGCACTTTGC|GGTTATACATGTCCTGGTTAAGATCCGGTA
CGCCCACCTGATCTCGTTTGACTGGCTTTC|CCTTAACCGTGTGGGCTCATTAATCTGGCA
TGTCGGCTACTTACGCCGTGTCGCTATCAC|CTTGTCCGTGTCGCTATCACATACATGTCC
GTCCTGGTTGAATTAGAGAAGAATATTGTT|GAGTTAACTATCAAGCCGTTCTACCGCGCC
AAACAAGTTGATCGTTTTCCTAGGTCCACA|CACATACATGTCCTGGTTCAACTCGTTCAA
TGGTTCAACTCGTTCAAGCACTCCAGTACT|TATCACATACATGTCCTGGTTGAAGTACCG
CCTAGATCACATCTCTTTTAGCTCGAAGCA|GGAAGAAGAAGGTAAGGAGTCGCGCTGGAT
AAATACCGATCAGCGGCAAAGCATGAAGTT|ACAATAATTCCGCAATACGTGTATCCACTC
ATGTCCTGGTTCAACGCCTAGATCACATCT|AACCCAAGATATTCTGGGAAGAAGAAGGTA
AAGGACGGTCGAGCTTAGCGACGGGACAGT|CGTGTCGCTATCACATACATGTCCTGGTTG
AATTTACGTCGAGCTCTGCGGTAGGATCCA|ACATACATGTCCTGGTTATATCCCAATTCT
CGTCGAGCTCTGCGGTAGGATCCATGCTTG|ATGTCCTGGTTATATCCCAATTCTTACTTC
ACCCGTGTCGCTATCACATACATGTCCTGG|CCTGGTTTAGCGAACCTGCACGGAAATACC
GATTATGCAGAGGGACTAGCCACCGCTGTC|AGCTTAGCGACGGGACAGTTATTTACCGTG
TACCGTGTCGCTATCACATACATGTCCTGG|GCCCACCTGATCTCGTTTGACTGGCTTTCC
CTCTTTTAGCTCGAAGCAAAAACCTACTTC|TAAGGAGTCGCGCTGGATTAGAGCTCCGGA
GTTAGTGTGGCGGCGATAGGTATGACCGTG|CTCTTGCGTAAACAAGTTGATCGTTTTCCT
CGGGACAGTTATTTACCGTGTCGCTATCAC|TCCTGGTTGAGTCGCCCACCTGATCTCGTT
TGGTTATACATGTCCTGGTTAAGATCCGGT|ACCGATCAGCGGCAAAGCATGAAGTTAGTG
TGTCCTGGTTATACATGTCCTGGTTAAGAT|GAAATACCGATCAGCGGCAAAGCATGAAGT
AAATAATGTACGCTCTTCGGGGTAAACACT|CTATCACATACATGTCCTGGTTCAACGCCT
TAAAATAACACCGTGTCGCTATCACATACA|TCCTGGTTTGGATATCCATCTTGCGAGTGC
AGGCCCAGGCCCAGGCGTTGCCCCCGTGTC|TATTGTTCTTACAGTGCGGCGAGCCGACGT
ACATACATGTCCTGGTTCAACTCGTTCAAG|CTTCCGTGTCGCTATCACATACATGTCCTG
CGTGAACCTGAAATAATGTACGCTCTTCGG|AACCGTGTCGCTATCACATACATGTCCTGG
CCCTGGCACTTTGCTCCATCGCGCCCCGGG|GTTAAGATCCGGTATGACACCCGTGTCGCT
CTCTTGCGTAAACAAGTTGATCGTTTTCCT|TGTCGCTATCACATACATGTCCTGGTTCAA
AATTCTTACTTCCGTGAACCTGAAATAATG|GCAAAATTCACTAACCGTGTCGCTATCACA
CCCTTTAAACCAAGCGGACGCCCTGGCAAT|ACTTTGCTCCATCGCGCCCCGGGACAAACC
GTTTCCGACATAAGGGTAAGGACGGTCGAG|GGGGTAAACACTACGTCCGTGTCGCTATCA
TGATCCCGCAGCCGAGACATTAGGGCTTAG|GTGTCGCTATCACATACATGTCCTGGTTGA
GAAATACCGATCAGCGGCAAAGCATGAAGT|AACAATAATTCCGCAATACGTGTATCCACT
TCGCTATCACATACATGTCCTGGTTTAGCG|CCATCTTGCGAGTGCACTGTGGACAGAGAT
CGCGCTGGATTAGAGCTCCGGACATCCGTG|CCGTGTCGCTATCACCCGTGTCGCTATCAC
GTGATCTTGATTATGCAGAGGGACTAGCCA|GACGGTCGAGCTTAGCGACGGGACAGTTAT
GCAGGCAGTATCACGTGTCGGCTACTTACG|GCGGTAGGATCCATGCTTGTCCGTGTCGCT
GTTACAGGGTGTGATCTTGATTATGCAGAG|TAAGGGTAAGGACGGTCGAGCTTAGCGACG
CCCAGGCGTTGCCCCCGTGTCGCTATCACA|TACAGTGCGGCGAGCCGACGTCGCTACCTT
GTTCAACTCGTTCAAGCACTCCAGTACTAG|TCACATACATGTCCTGGTTGAAGTACCGTG
GTGTCGCTATCACATACATGTCCTGGTTTC|GAACCTGAAATAATGTACGCTCTTCGGGGT
AAGGTAAGGAGTCGCGCTGGATTAGAGCTC|TGCCGTAACAGTCCGTGTCGCTATCACCCG
ATAAGGTTGCGGACCTCTGATCCCGCAGCC|CAGTACTAGTTTACACCGTGTCGCTATCAC
TGTCGCTATCACATACATGTCCTGGTTCAA|ACGTCGCTACCTTCCGTGTCGCTATCACAT
TGCAGGCAGTATCACGTGTCGGCTACTTAC|TGCGGTAGGATCCATGCTTGTCCGTGTCGC
GTCCTGGTTTGGATATCCATCTTGCGAGTG|TAAGGTTGCGGACCTCTGATCCCGCAGCCG
CAGAGATACAGATGCCCAACAATAATTCCG|GGCTTAGTCCCGCAAATATAGGCCCAGGCC
GCCGTGTCGCTATCACATACATGTCCTGGT|TATCACATACATGTCCTGGTTTCCGACATA
ACTCTTGCGTAAACAAGTTGATCGTTTTCC|GTGTCGCTATCACATACATGTCCTGGTTCA
TTATACATGTCCTGGTTAAGATCCGGTATG|GATCAGCGGCAAAGCATGAAGTTAGTGTGG
TACGTCGAGCTCTGCGGTAGGATCCATGCT|ACATGTCCTGGTTATATCCCAATTCTTACT
TTCTGGGAAGAAGAAGGTAAGGAGTCGCGC|TCACGTGCGTGCATGCCGTAACAGTCCGTG
CATCCGGTATTGCAGGCAGTATCACGTGTC|CGTCGAGCTCTGCGGTAGGATCCATGCTTG
CGGCTACTTACGCCGTGTCGCTATCACATA|GTCCGTGTCGCTATCACATACATGTCCTGG
CAGGCGTTGCCCCCGTGTCGCTATCACATA|CAGTGCGGCGAGCCGACGTCGCTACCTTCC
AACACCGTGTCGCTATCACATACATGTCCT|TTTGGATATCCATCTTGCGAGTGCACTGTG
ATTTCATCCGGTATTGCAGGCAGTATCACG|TTTACGTCGAGCTCTGCGGTAGGATCCATG
CCACTCTTGCGTAAACAAGTTGATCGTTTT|CCGTGTCGCTATCACATACATGTCCTGGTT
TATCACATACATGTCCTGGTTGAGTCGCCC|TTTAGCTCGAAGCAAAAACCTACTTCCTTA
AGGCAAAATTCACTAACCGTGTCGCTATCA|AGTTCCCCTTTAAACCAAGCGGACGCCCTG
TCGCTATCACATACATGTCCTGGTTGAATT|TACATGTCCTGGTTGTGAGTTAACTATCAA
CAATTCTTACTTCCGTGAACCTGAAATAAT|GGCAAAATTCACTAACCGTGTCGCTATCAC
AACCTGCACGGAAATACCGATCAGCGGCAA|ACAGATGCCCAACAATAATTCCGCAATACG
TTCAACTCGTTCAAGCACTCCAGTACTAGT|CACATACATGTCCTGGTTGAAGTACCGTGT
GACATTAGGGCTTAGTCCCGCAAATATAGG|ACATGTCCTGGTTGAATTAGAGAAGAATAT
GGTTTACCCTGGCACTTTGCTCCATCGCGC|GTCCTGGTTAAGATCCGGTATGACACCCGT
GTCCTGGTTTAGCGAACCTGCACGGAAATA|CTGTGGACAGAGATACAGATGCCCAACAAT
TATCACATACATGTCCTGGTTGAATTAGAG|TGTCCTGGTTGTGAGTTAACTATCAAGCCG
ATGCCCAACAATAATTCCGCAATACGTGTA|GCAAATATAGGCCCAGGCCCAGGCGTTGCC
TTAAACCAAGCGGACGCCCTGGCAATAACC|TGCTCCATCGCGCCCCGGGACAAACCGGCT
TACGTGTATCCACTCTTGCGTAAACAAGTT|GCGTTGCCCCCGTGTCGCTATCACATACAT
GCCACCGCTGTCGCCGGCGAAATTTACGTC|TTATTTACCGTGTCGCTATCACATACATGT
AGGCAGTATCACGTGTCGGCTACTTACGCC|GGTAGGATCCATGCTTGTCCGTGTCGCTAT
TTTCCTAGGTCCACAGCAAGGATAAGGTTG|GTTCAACTCGTTCAAGCACTCCAGTACTAG
CGTATCAGTTCCCCTTTAAACCAAGCGGAC|TTTACCCTGGCACTTTGCTCCATCGCGCCC
CCGTGTCGCTATCACATACATGTCCTGGTT|TTCCTAGGTCCACAGCAAGGATAAGGTTGC
AATAGGTCACGTGCGTGCATGCCGTAACAG|TCCTGGTTTTTTAAAATAACACCGTGTCGC
CCTGGTTATATCCCAATTCTTACTTCCGTG|TTTCCAGCGAACAGGCAAAATTCACTAACC
AATAACACCGTGTCGCTATCACATACATGT|TGGTTTGGATATCCATCTTGCGAGTGCACT
TTAGTCCCGCAAATATAGGCCCAGGCCCAG|TTGAATTAGAGAAGAATATTGTTCTTACAG
GGCAAGCGTATCAGTTCCCCTTTAAACCAA|TCCTGGTTTACCCTGGCACTTTGCTCCATC
GAACCTGCACGGAAATACCGATCAGCGGCA|TACAGATGCCCAACAATAATTCCGCAATAC
TCCCCTTTAAACCAAGCGGACGCCCTGGCA|GCACTTTGCTCCATCGCGCCCCGGGACAAA
AATAATTCCGCAATACGTGTATCCACTCTT|GGCCCAGGCCCAGGCGTTGCCCCCGTGTCG
CTGGTTACAGGGTGTGATCTTGATTATGCA|ACATAAGGGTAAGGACGGTCGAGCTTAGCG
GGCGGCGATAGGTATGACCGTGTCGCTATC|TAAACAAGTTGATCGTTTTCCTAGGTCCAC
CAATAACCCAAGATATTCTGGGAAGAAGAA|AACCGGCTAAATAGGTCACGTGCGTGCATG
CGTGTCGCTATCACCCGTGTCGCTATCACA|TCACATACATGTCCTGGTTTAGCGAACCTG
ATACGTGTATCCACTCTTGCGTAAACAAGT|GGCGTTGCCCCCGTGTCGCTATCACATACA
GTCCTGGTTAAGATCCGGTATGACACCCGT|GCAAAGCATGAAGTTAGTGTGGCGGCGATA
ACAAGTTGATCGTTTTCCTAGGTCCACAGC|CATACATGTCCTGGTTCAACTCGTTCAAGC
ATCACATACATGTCCTGGTTGAATTAGAGA|GTCCTGGTTGTGAGTTAACTATCAAGCCGT
AAAAACCTACTTCCTTAACCGTGTGGGCTC|TTAGAGCTCCGGACATCCGTGTCGCTATCA
GCGACGGGACAGTTATTTACCGTGTCGCTA|CATGTCCTGGTTGAGTCGCCCACCTGATCT
CCTGGTTTACCCTGGCACTTTGCTCCATCG|CATGTCCTGGTTAAGATCCGGTATGACACC
ATCGCGCCCCGGGACAAACCGGCTAAATAG|CACCCGTGTCGCTATCACATACATGTCCTG
ATTTACCGTGTCGCTATCACATACATGTCC|GTCGCCCACCTGATCTCGTTTGACTGGCTT
GGAGTCGCGCTGGATTAGAGCTCCGGACAT|ACAGTCCGTGTCGCTATCACCCGTGTCGCT
ACCGTGTCGCTATCACATACATGTCCTGGT|CAAGCGGACGCCCTGGCAATAACCCAAGAT
GGAAGAAGAAGGTAAGGAGTCGCGCTGGAT|TGCGTGCATGCCGTAACAGTCCGTGTCGCT
AATATAGGCCCAGGCCCAGGCGTTGCCCCC|AAGAATATTGTTCTTACAGTGCGGCGAGCC
TGCTCCATCGCGCCCCGGGACAAACCGGCT|GTATGACACCCGTGTCGCTATCACATACAT
TCGCTATCACATACATGTCCTGGTTATATC|TGATCTCGTTTGACTGGCTTTCCAGCGAAC
ACCGTGTGGGCTCATTAATCTGGCAAGCGT|CGTGTCGCTATCACATACATGTCCTGGTTT
ACGTGTATCCACTCTTGCGTAAACAAGTTG|CGTTGCCCCCGTGTCGCTATCACATACATG
ATATAGGCCCAGGCCCAGGCGTTGCCCCCG|AGAATATTGTTCTTACAGTGCGGCGAGCCG
TCGAGCTTAGCGACGGGACAGTTATTTACC|TATCACATACATGTCCTGGTTGAGTCGCCC
TTTAGCTCGAAGCAAAAACCTACTTCCTTA|GAGTCGCGCTGGATTAGAGCTCCGGACATC
TGTCCTGGTTTGGATATCCATCTTGCGAGT|ATAAGGTTGCGGACCTCTGATCCCGCAGCC
TGACACCCGTGTCGCTATCACATACATGTC|GGCGGCGATAGGTATGACCGTGTCGCTATC
ACAGTCCGTGTCGCTATCACCCGTGTCGCT|TCGCTATCACATACATGTCCTGGTTTAGCG
AGTCGCCCACCTGATCTCGTTTGACTGGCT|CTTCCTTAACCGTGTGGGCTCATTAATCTG
TTCAACGCCTAGATCACATCTCTTTTAGCT|TATTCTGGGAAGAAGAAGGTAAGGAGTCGC
CTCATTAATCTGGCAAGCGTATCAGTTCCC|TCACATACATGTCCTGGTTTACCCTGGCAC
TAGGTCACGTGCGTGCATGCCGTAACAGTC|CTGGTTTTTTAAAATAACACCGTGTCGCTA
ACCCGTGTCGCTATCACATACATGTCCTGG|GCGATAGGTATGACCGTGTCGCTATCACAT
AAGGGTAAGGACGGTCGAGCTTAGCGACGG|TACGTCCGTGTCGCTATCACATACATGTCC
TACATGTCCTGGTTGAATTAGAGAAGAATA|GTTGTGAGTTAACTATCAAGCCGTTCTACC
CCCCTTTAAACCAAGCGGACGCCCTGGCAA|CACTTTGCTCCATCGCGCCCCGGGACAAAC
CCCAACAATAATTCCGCAATACGTGTATCC|AATATAGGCCCAGGCCCAGGCGTTGCCCCC
GGACAGTTATTTACCGTGTCGCTATCACAT|CTGGTTGAGTCGCCCACCTGATCTCGTTTG
GTCCGTGTCGCTATCACATACATGTCCTGG|CCGTGAACCTGAAATAATGTACGCTCTTCG
GCTATCACATACATGTCCTGGTTCAACTCG|CGCTACCTTCCGTGTCGCTATCACATACAT
GCTCGAAGCAAAAACCTACTTCCTTAACCG|CGCGCTGGATTAGAGCTCCGGACATCCGTG
TACCCTGGCACTTTGCTCCATCGCGCCCCG|TGGTTAAGATCCGGTATGACACCCGTGTCG
TCGTTTGACTGGCTTTCCAGCGAACAGGCA|GGCTCATTAATCTGGCAAGCGTATCAGTTC
TACATGTCCTGGTTGAGTCGCCCACCTGAT|CGAAGCAAAAACCTACTTCCTTAACCGTGT
ACATACATGTCCTGGTTTAGCGAACCTGCA|CGAGTGCACTGTGGACAGAGATACAGATGC
TATCACATACATGTCCTGGTTATACATGTC|GAACCTGCACGGAAATACCGATCAGCGGCA
CGTGTCGCTATCACATACATGTCCTGGTTG|ACATCTCTTTTAGCTCGAAGCAAAAACCTA
CCGGCGAAATTTACGTCGAGCTCTGCGGTA|CGCTATCACATACATGTCCTGGTTATATCC
AGGATCCATGCTTGTCCGTGTCGCTATCAC|CCAATTCTTACTTCCGTGAACCTGAAATAA
CACATACATGTCCTGGTTCAACGCCTAGAT|TGGCAATAACCCAAGATATTCTGGGAAGAA
TCGCGCTGGATTAGAGCTCCGGACATCCGT|TCCGTGTCGCTATCACCCGTGTCGCTATCA
AGTTAGTGTGGCGGCGATAGGTATGACCGT|ACTCTTGCGTAAACAAGTTGATCGTTTTCC
GGGTAAGGACGGTCGAGCTTAGCGACGGGA|CGTCCGTGTCGCTATCACATACATGTCCTG
GATCTTGATTATGCAGAGGGACTAGCCACC|CGGTCGAGCTTAGCGACGGGACAGTTATTT
AGGGTGTGATCTTGATTATGCAGAGGGACT|GTAAGGACGGTCGAGCTTAGCGACGGGACA
GGCTCATTAATCTGGCAAGCGTATCAGTTC|TATCACATACATGTCCTGGTTTACCCTGGC
GTTTACCCTGGCACTTTGCTCCATCGCGCC|TCCTGGTTAAGATCCGGTATGACACCCGTG
CCCCGTGTCGCTATCACATACATGTCCTGG|AGCCGACGTCGCTACCTTCCGTGTCGCTAT
GCAGCCGAGACATTAGGGCTTAGTCCCGCA|TATCACATACATGTCCTGGTTGAATTAGAG
ATAGGTCACGTGCGTGCATGCCGTAACAGT|CCTGGTTTTTTAAAATAACACCGTGTCGCT
GATCGTTTTCCTAGGTCCACAGCAAGGATA|GTCCTGGTTCAACTCGTTCAAGCACTCCAG
CGCTATCACATACATGTCCTGGTTACAGGG|TACATGTCCTGGTTTCCGACATAAGGGTAA
GTTATATCCCAATTCTTACTTCCGTGAACC|CAGCGAACAGGCAAAATTCACTAACCGTGT
TCCTGGTTCAACGCCTAGATCACATCTCTT|CCAAGATATTCTGGGAAGAAGAAGGTAAGG
TAATCTGGCAAGCGTATCAGTTCCCCTTTA|TACATGTCCTGGTTTACCCTGGCACTTTGC
TAAGGAGTCGCGCTGGATTAGAGCTCCGGA|GTAACAGTCCGTGTCGCTATCACCCGTGTC
CGTGTCGCTATCACATACATGTCCTGGTTC|AGCGGACGCCCTGGCAATAACCCAAGATAT
TCACATACATGTCCTGGTTGAGTCGCCCAC|TAGCTCGAAGCAAAAACCTACTTCCTTAAC
GCTCTTCGGGGTAAACACTACGTCCGTGTC|ATGTCCTGGTTCAACGCCTAGATCACATCT
TGAGTCGCCCACCTGATCTCGTTTGACTGG|TACTTCCTTAACCGTGTGGGCTCATTAATC
AACCCAAGATATTCTGGGAAGAAGAAGGTA|GGCTAAATAGGTCACGTGCGTGCATGCCGT
AAATAACACCGTGTCGCTATCACATACATG|CTGGTTTGGATATCCATCTTGCGAGTGCAC
ATACATGTCCTGGTTCAACTCGTTCAAGCA|TCCGTGTCGCTATCACATACATGTCCTGGT
GCTTAGTCCCGCAAATATAGGCCCAGGCCC|GGTTGAATTAGAGAAGAATATTGTTCTTAC
GGTATTGCAGGCAGTATCACGTGTCGGCTA|AGCTCTGCGGTAGGATCCATGCTTGTCCGT
TGGATTAGAGCTCCGGACATCCGTGTCGCT|TCGCTATCACCCGTGTCGCTATCACATACA
AACAGTCCGTGTCGCTATCACCCGTGTCGC|GTCGCTATCACATACATGTCCTGGTTTAGC
ATCACATACATGTCCTGGTTTCCGACATAA|AATAATGTACGCTCTTCGGGGTAAACACTA
CATGCCGTAACAGTCCGTGTCGCTATCACC|AACACCGTGTCGCTATCACATACATGTCCT
TGTCCTGGTTTAGCGAACCTGCACGGAAAT|ACTGTGGACAGAGATACAGATGCCCAACAA
TAACAGTCCGTGTCGCTATCACCCGTGTCG|TGTCGCTATCACATACATGTCCTGGTTTAG
ATGTCCTGGTTCAACTCGTTCAAGCACTCC|TGTCGCTATCACATACATGTCCTGGTTGAA
CAAGCGGACGCCCTGGCAATAACCCAAGAT|ATCGCGCCCCGGGACAAACCGGCTAAATAG
CGCCTAGATCACATCTCTTTTAGCTCGAAG|TGGGAAGAAGAAGGTAAGGAGTCGCGCTGG
TCCGACATAAGGGTAAGGACGGTCGAGCTT|GTAAACACTACGTCCGTGTCGCTATCACAT
CAGGGTGTGATCTTGATTATGCAGAGGGAC|GGTAAGGACGGTCGAGCTTAGCGACGGGAC
AGCTTAGCGACGGGACAGTTATTTACCGTG|CACATACATGTCCTGGTTGAGTCGCCCACC
TCACCCGTGTCGCTATCACATACATGTCCT|GTCCTGGTTTAGCGAACCTGCACGGAAATA
TCTTACTTCCGTGAACCTGAAATAATGTAC|AAATTCACTAACCGTGTCGCTATCACATAC
TCCTTAACCGTGTGGGCTCATTAATCTGGC|GACATCCGTGTCGCTATCACATACATGTCC
GCGCTGGATTAGAGCTCCGGACATCCGTGT|CGTGTCGCTATCACCCGTGTCGCTATCACA
TTACAGGGTGTGATCTTGATTATGCAGAGG|AAGGGTAAGGACGGTCGAGCTTAGCGACGG
CGTGCGTGCATGCCGTAACAGTCCGTGTCG|TTTAAAATAACACCGTGTCGCTATCACATA
AGTACTAGTTTACACCGTGTCGCTATCACA|GTACCGTGTCGCTATCACATACATGTCCTG
ACATACATGTCCTGGTTACAGGGTGTGATC|CCTGGTTTCCGACATAAGGGTAAGGACGGT
TTGTCCGTGTCGCTATCACATACATGTCCT|TTCCGTGAACCTGAAATAATGTACGCTCTT
ATCACATACATGTCCTGGTTATACATGTCC|AACCTGCACGGAAATACCGATCAGCGGCAA
ATAACACCGTGTCGCTATCACATACATGTC|GGTTTGGATATCCATCTTGCGAGTGCACTG
TTATTTACCGTGTCGCTATCACATACATGT|GAGTCGCCCACCTGATCTCGTTTGACTGGC
GTGTCGCTATCACATACATGTCCTGGTTTT|TAGGTATGACCGTGTCGCTATCACATACAT
CACGTGTCGGCTACTTACGCCGTGTCGCTA|CATGCTTGTCCGTGTCGCTATCACATACAT
TACATGTCCTGGTTATATCCCAATTCTTAC|GACTGGCTTTCCAGCGAACAGGCAAAATTC
TAGGTCCACAGCAAGGATAAGGTTGCGGAC|ACTCGTTCAAGCACTCCAGTACTAGTTTAC
CTACGTCCGTGTCGCTATCACATACATGTC|CTAGATCACATCTCTTTTAGCTCGAAGCAA
ACCTGCACGGAAATACCGATCAGCGGCAAA|CAGATGCCCAACAATAATTCCGCAATACGT
CGTGTCGCTATCACATACATGTCCTGGTTA|GGTTTAGCGAACCTGCACGGAAATACCGAT
AGAGCTCCGGACATCCGTGTCGCTATCACA|TCACCCGTGTCGCTATCACATACATGTCCT
GTAAGGAGTCGCGCTGGATTAGAGCTCCGG|CGTAACAGTCCGTGTCGCTATCACCCGTGT
CAGGCCCAGGCGTTGCCCCCGTGTCGCTAT|TTCTTACAGTGCGGCGAGCCGACGTCGCTA
TGGCAATAACCCAAGATATTCTGGGAAGAA|ACAAACCGGCTAAATAGGTCACGTGCGTGC
AAACCTACTTCCTTAACCGTGTGGGCTCAT|AGAGCTCCGGACATCCGTGTCGCTATCACA
GAGCTCTGCGGTAGGATCCATGCTTGTCCG|CCTGGTTATATCCCAATTCTTACTTCCGTG
TGGACAGAGATACAGATGCCCAACAATAAT|TTAGGGCTTAGTCCCGCAAATATAGGCCCA
TTCCGTGAACCTGAAATAATGTACGCTCTT|ACTAACCGTGTCGCTATCACATACATGTCC
CCGTGTCGCTATCACCCGTGTCGCTATCAC|ATCACATACATGTCCTGGTTTAGCGAACCT
GACTGGCTTTCCAGCGAACAGGCAAAATTC|TTAATCTGGCAAGCGTATCAGTTCCCCTTT
GCCGAGACATTAGGGCTTAGTCCCGCAAAT|CACATACATGTCCTGGTTGAATTAGAGAAG
GGAAATACCGATCAGCGGCAAAGCATGAAG|CAACAATAATTCCGCAATACGTGTATCCAC
CGAAATTTACGTCGAGCTCTGCGGTAGGAT|ATCACATACATGTCCTGGTTATATCCCAAT
ACCTACTTCCTTAACCGTGTGGGCTCATTA|AGCTCCGGACATCCGTGTCGCTATCACATA
TAACACCGTGTCGCTATCACATACATGTCC|GTTTGGATATCCATCTTGCGAGTGCACTGT
TTCCCCTTTAAACCAAGCGGACGCCCTGGC|GGCACTTTGCTCCATCGCGCCCCGGGACAA
TATCACATACATGTCCTGGTTTTTTAAAAT|GACCGTGTCGCTATCACATACATGTCCTGG
GTAAGGACGGTCGAGCTTAGCGACGGGACA|TCCGTGTCGCTATCACATACATGTCCTGGT
TGGCGGCGATAGGTATGACCGTGTCGCTAT|GTAAACAAGTTGATCGTTTTCCTAGGTCCA
CGTGCATGCCGTAACAGTCCGTGTCGCTAT|AAATAACACCGTGTCGCTATCACATACATG
TATCACATACATGTCCTGGTTATATCCCAA|CTCGTTTGACTGGCTTTCCAGCGAACAGGC
GCGTTGCCCCCGTGTCGCTATCACATACAT|TGCGGCGAGCCGACGTCGCTACCTTCCGTG
TCGGCTACTTACGCCGTGTCGCTATCACAT|TGTCCGTGTCGCTATCACATACATGTCCTG
AGGTTGCGGACCTCTGATCCCGCAGCCGAG|TACTAGTTTACACCGTGTCGCTATCACATA
CTTCGGGGTAAACACTACGTCCGTGTCGCT|TCCTGGTTCAACGCCTAGATCACATCTCTT
AGGCGTTGCCCCCGTGTCGCTATCACATAC|AGTGCGGCGAGCCGACGTCGCTACCTTCCG
CGTGTCGCTATCACATACATGTCCTGGTTT|ATATCCATCTTGCGAGTGCACTGTGGACAG
GCAATACGTGTATCCACTCTTGCGTAAACA|CCAGGCGTTGCCCCCGTGTCGCTATCACAT
GTATGACCGTGTCGCTATCACATACATGTC|ATCGTTTTCCTAGGTCCACAGCAAGGATAA
GTGTGGCGGCGATAGGTATGACCGTGTCGC|TGCGTAAACAAGTTGATCGTTTTCCTAGGT
CCGACATAAGGGTAAGGACGGTCGAGCTTA|TAAACACTACGTCCGTGTCGCTATCACATA
CATGTCCTGGTTATACATGTCCTGGTTAAG|CGGAAATACCGATCAGCGGCAAAGCATGAA
TGGGCTCATTAATCTGGCAAGCGTATCAGT|GCTATCACATACATGTCCTGGTTTACCCTG
CGCTGTCGCCGGCGAAATTTACGTCGAGCT|TACCGTGTCGCTATCACATACATGTCCTGG
GATCCGGTATGACACCCGTGTCGCTATCAC|AGTTAGTGTGGCGGCGATAGGTATGACCGT
AAGATATTCTGGGAAGAAGAAGGTAAGGAG|AATAGGTCACGTGCGTGCATGCCGTAACAG
ACACCGTGTCGCTATCACATACATGTCCTG|CTATCACATACATGTCCTGGTTGTGAGTTA
AGTCGCGCTGGATTAGAGCTCCGGACATCC|AGTCCGTGTCGCTATCACCCGTGTCGCTAT
CGGGGTAAACACTACGTCCGTGTCGCTATC|TGGTTCAACGCCTAGATCACATCTCTTTTA
ATCCATGCTTGTCCGTGTCGCTATCACATA|ATTCTTACTTCCGTGAACCTGAAATAATGT
GCTCATTAATCTGGCAAGCGTATCAGTTCC|ATCACATACATGTCCTGGTTTACCCTGGCA
CTCGAAGCAAAAACCTACTTCCTTAACCGT|GCGCTGGATTAGAGCTCCGGACATCCGTGT
AGCTCCGGACATCCGTGTCGCTATCACATA|ACCCGTGTCGCTATCACATACATGTCCTGG
TCGGGGTAAACACTACGTCCGTGTCGCTAT|CTGGTTCAACGCCTAGATCACATCTCTTTT
CGTGTCGCTATCACATACATGTCCTGGTTG|CACATACATGTCCTGGTTGTGAGTTAACTA
TAAGGACGGTCGAGCTTAGCGACGGGACAG|CCGTGTCGCTATCACATACATGTCCTGGTT
TCCTGGTTGAATTAGAGAAGAATATTGTTC|AGTTAACTATCAAGCCGTTCTACCGCGCCC
GATCAGCGGCAAAGCATGAAGTTAGTGTGG|TTCCGCAATACGTGTATCCACTCTTGCGTA
ATTAGAGCTCCGGACATCCGTGTCGCTATC|CTATCACCCGTGTCGCTATCACATACATGT
CTCCAGTACTAGTTTACACCGTGTCGCTAT|TGAAGTACCGTGTCGCTATCACATACATGT
CCGTGTCGCTATCACATACATGTCCTGGTT|ATCACATACATGTCCTGGTTATACATGTCC
CGTGTCGCTATCACATACATGTCCTGGTTT|TCCTAGGTCCACAGCAAGGATAAGGTTGCG
CCGCAATACGTGTATCCACTCTTGCGTAAA|GCCCAGGCGTTGCCCCCGTGTCGCTATCAC
CCGGCTAAATAGGTCACGTGCGTGCATGCC|ATACATGTCCTGGTTTTTTAAAATAACACC
TAAGGTTGCGGACCTCTGATCCCGCAGCCG|AGTACTAGTTTACACCGTGTCGCTATCACA
CGCAGCCGAGACATTAGGGCTTAGTCCCGC|CTATCACATACATGTCCTGGTTGAATTAGA
GGGCTTAGTCCCGCAAATATAGGCCCAGGC|CTGGTTGAATTAGAGAAGAATATTGTTCTT
GTCCTGGTTCAACGCCTAGATCACATCTCT|CCCAAGATATTCTGGGAAGAAGAAGGTAAG
TTTACACCGTGTCGCTATCACATACATGTC|TCGCTATCACATACATGTCCTGGTTGTGAG
GCCCAGGCGTTGCCCCCGTGTCGCTATCAC|TTACAGTGCGGCGAGCCGACGTCGCTACCT
GCACGGAAATACCGATCAGCGGCAAAGCAT|TGCCCAACAATAATTCCGCAATACGTGTAT
ATACATGTCCTGGTTTTTTAAAATAACACC|GTCGCTATCACATACATGTCCTGGTTTGGA
GTAAACAAGTTGATCGTTTTCCTAGGTCCA|ATCACATACATGTCCTGGTTCAACTCGTTC
ACGTGCGTGCATGCCGTAACAGTCCGTGTC|TTTTAAAATAACACCGTGTCGCTATCACAT
CAAGTTGATCGTTTTCCTAGGTCCACAGCA|ATACATGTCCTGGTTCAACTCGTTCAAGCA
CTCGTTTGACTGGCTTTCCAGCGAACAGGC|GGGCTCATTAATCTGGCAAGCGTATCAGTT
CCTGGTTTCCGACATAAGGGTAAGGACGGT|CTTCGGGGTAAACACTACGTCCGTGTCGCT
CTGCACGGAAATACCGATCAGCGGCAAAGC|GATGCCCAACAATAATTCCGCAATACGTGT
CACTGTGGACAGAGATACAGATGCCCAACA|AGACATTAGGGCTTAGTCCCGCAAATATAG
CACGGAAATACCGATCAGCGGCAAAGCATG|GCCCAACAATAATTCCGCAATACGTGTATC
CGTGTCGCTATCACATACATGTCCTGGTTT|ATAGGTATGACCGTGTCGCTATCACATACA
CAGCGAACAGGCAAAATTCACTAACCGTGT|AGCGTATCAGTTCCCCTTTAAACCAAGCGG
CCGGACATCCGTGTCGCTATCACATACATG|GTGTCGCTATCACATACATGTCCTGGTTAT
TCTGGGAAGAAGAAGGTAAGGAGTCGCGCT|CACGTGCGTGCATGCCGTAACAGTCCGTGT
CCAATTCTTACTTCCGTGAACCTGAAATAA|AGGCAAAATTCACTAACCGTGTCGCTATCA
CGAGACATTAGGGCTTAGTCCCGCAAATAT|CATACATGTCCTGGTTGAATTAGAGAAGAA
GCGGTAGGATCCATGCTTGTCCGTGTCGCT|ATATCCCAATTCTTACTTCCGTGAACCTGA
ACATTAGGGCTTAGTCCCGCAAATATAGGC|CATGTCCTGGTTGAATTAGAGAAGAATATT
AGATCCGGTATGACACCCGTGTCGCTATCA|AAGTTAGTGTGGCGGCGATAGGTATGACCG
CCTGAAATAATGTACGCTCTTCGGGGTAAA|GTCGCTATCACATACATGTCCTGGTTCAAC
CACATACATGTCCTGGTTTCCGACATAAGG|TAATGTACGCTCTTCGGGGTAAACACTACG
CAAAAACCTACTTCCTTAACCGTGTGGGCT|ATTAGAGCTCCGGACATCCGTGTCGCTATC
GTGTCGCTATCACATACATGTCCTGGTTGA|ACATACATGTCCTGGTTGTGAGTTAACTAT
GTTTGACTGGCTTTCCAGCGAACAGGCAAA|CTCATTAATCTGGCAAGCGTATCAGTTCCC
CGTAACAGTCCGTGTCGCTATCACCCGTGT|CGTGTCGCTATCACATACATGTCCTGGTTT
AGTTATTTACCGTGTCGCTATCACATACAT|TTGAGTCGCCCACCTGATCTCGTTTGACTG
GGATAAGGTTGCGGACCTCTGATCCCGCAG|TCCAGTACTAGTTTACACCGTGTCGCTATC
TCGCTATCACATACATGTCCTGGTTCAACG|GACGCCCTGGCAATAACCCAAGATATTCTG
TTTACCGTGTCGCTATCACATACATGTCCT|TCGCCCACCTGATCTCGTTTGACTGGCTTT
GAAGAAGGTAAGGAGTCGCGCTGGATTAGA|TGCATGCCGTAACAGTCCGTGTCGCTATCA
TATCACATACATGTCCTGGTTTCCGACATA|AAATAATGTACGCTCTTCGGGGTAAACACT
TCGCTATCACATACATGTCCTGGTTCAACT|GTCGCTACCTTCCGTGTCGCTATCACATAC
GCCCCCGTGTCGCTATCACATACATGTCCT|CGAGCCGACGTCGCTACCTTCCGTGTCGCT
